filename,director,speaker,trial_value,trial_start,trial_end,trial_length,sign_start,sign_end,sign_length,sign_value,sign_notes,iconic,signOrigin,T0Check
Colour_game_01_1_Jordan-India_After_one_week.eaf,1,1,16,800078,817798,17720,800078,817798,17720,,NA,,,FALSE
Colour_game_01_1_Jordan-India_After_one_week.eaf,1,2,16,800078,817798,17720,803027,804306,1279,GREEN(ISL),NA,NA,NA,TRUE
Colour_game_01_1_Jordan-India_After_one_week.eaf,1,2,16,800078,817798,17720,808288,808964,676,WHITE,NA,NA,NA,TRUE
Colour_game_01_1_Jordan-India_After_one_week.eaf,1,2,16,800078,817798,17720,809359,809908,549,GREEN(ISL),NA,NA,NA,TRUE
Colour_game_01_1_Jordan-India_After_one_week.eaf,1,2,16,800078,817798,17720,809908,810279,371,WHITE,NA,NA,NA,TRUE
Colour_game_01_1_Jordan-India_After_one_week.eaf,1,2,16,800078,817798,17720,810339,810545,206,벽,IX,NA,NA,TRUE
Colour_game_01_1_Jordan-India_After_one_week.eaf,1,2,16,800078,817798,17720,810545,810666,121,SAME,NA,NA,NA,TRUE
Colour_game_01_1_Jordan-India_After_one_week.eaf,1,2,16,800078,817798,17720,810666,811337,671,WHITE,NA,NA,NA,TRUE
Colour_game_01_1_Jordan-India_After_one_week.eaf,1,2,6,68400,75200,6800,71575,73278,1703,T0보다 Check쪽이 맞음?,NA,NA,NA,TRUE
Colour_game_01_1_Jordan-India_After_one_week.eaf,1,1,6,150779,154909,4130,153675,154541,866,WHITE,NA,,,FALSE
Colour_game_01_1_Jordan-India_After_one_week.eaf,1,1,5,2025520,2027634,2114,2025560,2026980,1420,BROWN,IX#INSL,Yes,INSL,FALSE
Colour_game_01_1_Jordan-India_After_one_week.eaf,1,1,3,1124503,1127594,3091,1124584,1125884,1300,RED,OS,Yes,JSL,FALSE
Colour_game_01_1_Jordan-India_After_one_week.eaf,1,2,3,1124503,1127594,3091,1126412,1127448,1036,RED,OS,NA,NA,TRUE
Colour_game_01_1_Jordan-India_After_one_week.eaf,1,1,22,1790430,1889866,99436,1790430,1802547,12117,ARM+WHITE,IX,,,FALSE
Colour_game_01_1_Jordan-India_After_one_week.eaf,1,1,22,1790430,1889866,99436,1808252,1823184,14932,3가지가 있어 맞지?,NA,,,FALSE
Colour_game_01_1_Jordan-India_After_one_week.eaf,1,1,22,1790430,1889866,99436,1823184,1828435,5251,첫째는 밝은 것,NA,,,FALSE
Colour_game_01_1_Jordan-India_After_one_week.eaf,1,1,22,1790430,1889866,99436,1828584,1833778,5194,두번째 약간 어둡게,NA,,,FALSE
Colour_game_01_1_Jordan-India_After_one_week.eaf,1,1,22,1790430,1889866,99436,1833778,1839923,6145,세번째는 팔과 같아,NA,,,FALSE
Colour_game_01_1_Jordan-India_After_one_week.eaf,1,1,22,1790430,1889866,99436,1839923,1845176,5253,세번째야,NA,,,FALSE
Colour_game_01_1_Jordan-India_After_one_week.eaf,1,1,22,1790430,1889866,99436,1884505,1890038,5533,그럼 첫째 딱맞은 것 2째 약간 어둡게 그치? 그거야!,NA,,,FALSE
Colour_game_01_1_Jordan-India_After_one_week.eaf,1,2,22,1790430,1889866,99436,1873921,1884505,10584,3개가 아니라 2개 있어,NA,NA,NA,TRUE
Colour_game_01_1_Jordan-India_After_one_week.eaf,1,1,7,144084,146484,2400,145280,145759,479,BLACK,OS,Yes,ISL,FALSE
Colour_game_01_1_Jordan-India_After_one_week.eaf,1,1,19,249100,400500,151400,250091,251788,1697,YELLOW,OS,No,JSL,FALSE
Colour_game_01_1_Jordan-India_After_one_week.eaf,1,1,19,249100,400500,151400,251904,252274,370,SAME,NA,,,FALSE
Colour_game_01_1_Jordan-India_After_one_week.eaf,1,1,19,249100,400500,151400,252328,254290,1962,C,CL,Yes,,FALSE
Colour_game_01_1_Jordan-India_After_one_week.eaf,1,1,19,249100,400500,151400,254450,256523,2073,PEEL,LW,Yes,,FALSE
Colour_game_01_1_Jordan-India_After_one_week.eaf,1,1,19,249100,400500,151400,256523,257127,604,IX(B형)->C,NA,Yes,,FALSE
Colour_game_01_1_Jordan-India_After_one_week.eaf,1,1,19,249100,400500,151400,257264,258185,921,BRIGHT,NA,,,FALSE
Colour_game_01_1_Jordan-India_After_one_week.eaf,1,1,19,249100,400500,151400,258377,259377,1000,PEEL,LW,Yes,,FALSE
Colour_game_01_1_Jordan-India_After_one_week.eaf,1,1,19,249100,400500,151400,260150,261761,1611,EAT#C,NA,,,FALSE
Colour_game_01_1_Jordan-India_After_one_week.eaf,1,1,19,249100,400500,151400,261974,263152,1178,BRIGHT,NA,,,FALSE
Colour_game_01_1_Jordan-India_After_one_week.eaf,1,1,19,249100,400500,151400,272320,274520,2200,YELLOW,OS,,JSL,FALSE
Colour_game_01_1_Jordan-India_After_one_week.eaf,1,1,19,249100,400500,151400,274560,276100,1540,YELLOW2,OS,Yes,JSL,FALSE
Colour_game_01_1_Jordan-India_After_one_week.eaf,1,1,19,249100,400500,151400,276110,283130,7020,LEMON#ACTION,LW,Yes,,FALSE
Colour_game_01_1_Jordan-India_After_one_week.eaf,1,1,19,249100,400500,151400,283160,285360,2200,LEMON#PEEL,LW,Yes,,FALSE
Colour_game_01_1_Jordan-India_After_one_week.eaf,1,1,19,249100,400500,151400,285380,288260,2880,LW:Description:LEMON,NA,Yes,,FALSE
Colour_game_01_1_Jordan-India_After_one_week.eaf,1,1,19,249100,400500,151400,288300,291880,3580,LEMON#ACTION,LW,Yes,,FALSE
Colour_game_01_1_Jordan-India_After_one_week.eaf,1,1,19,249100,400500,151400,291900,300560,8660,NO A other SIGN(비교대상),NA,,,FALSE
Colour_game_01_1_Jordan-India_After_one_week.eaf,1,1,19,249100,400500,151400,306399,319530,13131,YESDERDAY SHOPPING',SE,No,,FALSE
Colour_game_01_1_Jordan-India_After_one_week.eaf,1,1,19,249100,400500,151400,328691,331248,2557,SAME,NA,,,FALSE
Colour_game_01_1_Jordan-India_After_one_week.eaf,1,1,19,249100,400500,151400,341526,348200,6674,NO A YES B^Focus,NA,,,FALSE
Colour_game_01_1_Jordan-India_After_one_week.eaf,1,1,19,249100,400500,151400,361600,364900,3300,FLOOR,IX,Yes,,FALSE
Colour_game_01_1_Jordan-India_After_one_week.eaf,1,1,19,249100,400500,151400,367025,369225,2200,BRIGHT,NA,Yes,,FALSE
Colour_game_01_1_Jordan-India_After_one_week.eaf,1,1,19,249100,400500,151400,369625,371625,2000,SUN,NA,Yes,,FALSE
Colour_game_01_1_Jordan-India_After_one_week.eaf,1,1,19,249100,400500,151400,371925,374025,2100,SAME,NA,,,FALSE
Colour_game_01_1_Jordan-India_After_one_week.eaf,1,1,19,249100,400500,151400,385815,390130,4315,GOLD,Repeat#ISL,NA,NA,TRUE
Colour_game_01_1_Jordan-India_After_one_week.eaf,1,2,19,249100,400500,151400,265956,266935,979,SIGNING,NA,,,FALSE
Colour_game_01_1_Jordan-India_After_one_week.eaf,1,2,19,249100,400500,151400,266935,267021,86,WHAT,NA,,,FALSE
Colour_game_01_1_Jordan-India_After_one_week.eaf,1,2,19,249100,400500,151400,267021,267272,251,SIGNING,NA,,,FALSE
Colour_game_01_1_Jordan-India_After_one_week.eaf,1,2,19,249100,400500,151400,267351,267783,432,COLOR,NA,,,FALSE
Colour_game_01_1_Jordan-India_After_one_week.eaf,1,2,19,249100,400500,151400,259953,262332,2379,Repeat(PEEL)?,NA,NA,NA,TRUE
Colour_game_01_1_Jordan-India_After_one_week.eaf,1,2,19,249100,400500,151400,262525,265691,3166,Repeat(EAT)?,NA,NA,NA,TRUE
Colour_game_01_1_Jordan-India_After_one_week.eaf,1,2,19,249100,400500,151400,266025,267807,1782,WHAT SIGNING,NA,NA,NA,TRUE
Colour_game_01_1_Jordan-India_After_one_week.eaf,1,2,19,249100,400500,151400,279147,280294,1147,REPEAT-LEMON,NA,NA,NA,TRUE
Colour_game_01_1_Jordan-India_After_one_week.eaf,1,2,19,249100,400500,151400,281170,283490,2320,LOMON+DRINK,LW,NA,NA,TRUE
Colour_game_01_1_Jordan-India_After_one_week.eaf,1,2,19,249100,400500,151400,291193,293423,2230,leman, REPEAT-CL,NA,NA,TRUE
Colour_game_01_1_Jordan-India_After_one_week.eaf,1,2,19,249100,400500,151400,293985,294547,562,Continuer,NA,NA,NA,TRUE
Colour_game_01_1_Jordan-India_After_one_week.eaf,1,2,19,249100,400500,151400,300245,301187,942,Continuer,NA,NA,NA,TRUE
Colour_game_01_1_Jordan-India_After_one_week.eaf,1,2,19,249100,400500,151400,305315,306050,735,SIGNING#WHAT?,NA,NA,NA,TRUE
Colour_game_01_1_Jordan-India_After_one_week.eaf,1,2,19,249100,400500,151400,306259,309282,3023,COLOR^SIGNING,NA,NA,NA,TRUE
Colour_game_01_1_Jordan-India_After_one_week.eaf,1,2,19,249100,400500,151400,320386,323869,3483,Repeat(자르는 걸 그대로 따라하고)^DON'T UNDERSTAND,NA,NA,NA,TRUE
Colour_game_01_1_Jordan-India_After_one_week.eaf,1,2,19,249100,400500,151400,332300,347900,15600,당신의 수화에서..ACTION레몬을 ,supposition,NA,NA,TRUE
Colour_game_01_1_Jordan-India_After_one_week.eaf,1,2,19,249100,400500,151400,358400,362000,3600,그것이니?  ,POINTING,NA,NA,TRUE
Colour_game_01_1_Jordan-India_After_one_week.eaf,1,2,19,249100,400500,151400,395113,395934,821,DARK(repeat),NA,NA,NA,TRUE
Colour_game_01_1_Jordan-India_After_one_week.eaf,1,1,20,828721,835390,6669,830682,831412,730,RED,OS,Yes,JSL,FALSE
Colour_game_01_1_Jordan-India_After_one_week.eaf,1,1,20,828721,835390,6669,833354,834225,871,RED,OS,Yes,JSL,FALSE
Colour_game_01_1_Jordan-India_After_one_week.eaf,1,2,20,828721,835390,6669,832171,833238,1067,RED,OS,NA,NA,TRUE
Colour_game_01_1_Jordan-India_After_one_week.eaf,1,2,20,828721,835390,6669,833302,835341,2039,RED,OS,NA,NA,TRUE
Colour_game_01_1_Jordan-India_After_one_week.eaf,1,1,14,1741805,1744745,2940,1741962,1743205,1243,PLANTS,LW,,,FALSE
Colour_game_01_1_Jordan-India_After_one_week.eaf,1,1,14,1741805,1744745,2940,1743205,1744685,1480,THERE,IX,,,FALSE
Colour_game_01_1_Jordan-India_After_one_week.eaf,1,1,5,1936121,1938043,1922,1936193,1937985,1792,RED,OS#NSL,Yes,NSL,FALSE
Colour_game_01_1_Jordan-India_After_one_week.eaf,1,1,21,1341127,1471692,130565,1362558,1381209,18651,ORANGE PEEL,NA,,,FALSE
Colour_game_01_1_Jordan-India_After_one_week.eaf,1,1,21,1341127,1471692,130565,1386061,1396100,10039,CUTTING(ACTION) ORANGE,NA,,,FALSE
Colour_game_01_1_Jordan-India_After_one_week.eaf,1,1,21,1341127,1471692,130565,1409394,1413679,4285,THAT IS ORANGE PEEL SAME,NA,,,FALSE
Colour_game_01_1_Jordan-India_After_one_week.eaf,1,1,21,1341127,1471692,130565,1428042,1438000,9958,첫번째 밝은 것 두번째 어두운 것인데 두번째야!,NA,,,FALSE
Colour_game_01_1_Jordan-India_After_one_week.eaf,1,1,21,1341127,1471692,130565,1442261,1446219,3958,아까 말했듯이 오렌지색!,NA,,,FALSE
Colour_game_01_1_Jordan-India_After_one_week.eaf,1,1,21,1341127,1471692,130565,1466700,1469966,3266,두번째야!,NA,,,FALSE
Colour_game_01_1_Jordan-India_After_one_week.eaf,1,2,21,1341127,1471692,130565,1379998,1384148,4150,ACTION(눈) WITH ANGERINE ,NA,NA,NA,TRUE
Colour_game_01_1_Jordan-India_After_one_week.eaf,1,2,21,1341127,1471692,130565,1398398,1404200,5802,PEEL ORANGE^냄새맡게 되는 특성,NA,NA,NA,TRUE
Colour_game_01_1_Jordan-India_After_one_week.eaf,1,2,21,1341127,1471692,130565,1404399,1408949,4550,PEEL ORANGE EAT SEED  THROW-OUT(씨앗먹다가 버리다) ,NA,NA,NA,TRUE
Colour_game_01_1_Jordan-India_After_one_week.eaf,1,2,21,1341127,1471692,130565,1419165,1429087,9922,PEEL COLOR TWO,NA,NA,NA,TRUE
Colour_game_01_1_Jordan-India_After_one_week.eaf,1,2,21,1341127,1471692,130565,1460918,1465200,4282,첫번째는 ACTION(눈으로 귤을 말하면서 밝고),NA,NA,NA,TRUE
Colour_game_01_1_Jordan-India_After_one_week.eaf,1,2,21,1341127,1471692,130565,1467500,1470400,2900,두번째로 어두운 것?,NA,NA,NA,TRUE
Colour_game_01_1_Jordan-India_After_one_week.eaf,1,1,7,9161,20518,11357,9225,9950,725,SAME,NA,,,FALSE
Colour_game_01_1_Jordan-India_After_one_week.eaf,1,1,7,9161,20518,11357,10050,10875,825,hair,IX,Yes,,FALSE
Colour_game_01_1_Jordan-India_After_one_week.eaf,1,1,7,9161,20518,11357,10955,12325,1370,BLACK,OS#JSL,Yes,JSL,FALSE
Colour_game_01_1_Jordan-India_After_one_week.eaf,1,1,7,9161,20518,11357,13967,15150,1183,DARK,NA,,,FALSE
Colour_game_01_1_Jordan-India_After_one_week.eaf,1,1,7,9161,20518,11357,16129,17673,1544,NIGHT,NA,,,FALSE
Colour_game_01_1_Jordan-India_After_one_week.eaf,1,1,7,9161,20518,11357,17690,19207,1517,DARK,NA,,,FALSE
Colour_game_01_1_Jordan-India_After_one_week.eaf,1,1,7,9161,20518,11357,19552,20529,977,SAME,NA,,,FALSE
Colour_game_01_1_Jordan-India_After_one_week.eaf,1,2,7,9161,20518,11357,12202,12932,730,BLACK,OS#ISL,NA,NA,TRUE
Colour_game_01_1_Jordan-India_After_one_week.eaf,1,2,7,9161,20518,11357,12932,15022,2090,DARK,NA,NA,NA,TRUE
Colour_game_01_1_Jordan-India_After_one_week.eaf,1,2,7,9161,20518,11357,16722,18216,1494,CHECK? ,REPEAT,NA,NA,TRUE
Colour_game_01_1_Jordan-India_After_one_week.eaf,2,2,7,148945,149931,986,148962,149920,958,BLACK,OS#ISL,Yes,ISL,FALSE
Colour_game_01_1_Jordan-India_After_one_week.eaf,2,2,9,849751,1022739,172988,849751,1022739,172988,,NA,,,FALSE
Colour_game_01_1_Jordan-India_After_one_week.eaf,2,1,8,1646430,1691859,45429,1658488,1661851,3363,BLACKBOARD,NA,NA,NA,TRUE
Colour_game_01_1_Jordan-India_After_one_week.eaf,2,1,8,1646430,1691859,45429,1666242,1668765,2523,BOOGER,NA,NA,NA,TRUE
Colour_game_01_1_Jordan-India_After_one_week.eaf,2,2,8,1646430,1691859,45429,1648682,1652244,3562,,NA,,,FALSE
Colour_game_01_1_Jordan-India_After_one_week.eaf,2,2,8,1646430,1691859,45429,1652244,1659400,7156,TREE DARK,NA,,,FALSE
Colour_game_01_1_Jordan-India_After_one_week.eaf,2,2,8,1646430,1691859,45429,1661851,1666833,4982,BOOGER코딱지와 같은 어두운 색,NA,,,FALSE
Colour_game_01_1_Jordan-India_After_one_week.eaf,2,2,8,1646430,1691859,45429,1676950,1680500,3550,arm,IX,,,FALSE
Colour_game_01_1_Jordan-India_After_one_week.eaf,2,2,22,1892957,1897298,4341,1892957,1897298,4341,SAME,NA,,,FALSE
Colour_game_01_1_Jordan-India_After_one_week.eaf,2,2,3,1134102,1139742,5640,1136146,1136406,260,RED,NA,Yes,ISL,FALSE
Colour_game_01_1_Jordan-India_After_one_week.eaf,2,2,3,1134102,1139742,5640,1136406,1136817,411,INDIA,NA,Yes,NSL,FALSE
Colour_game_01_1_Jordan-India_After_one_week.eaf,2,2,6,154909,157137,2228,155229,156986,1757,WHITE,NA,,,FALSE
Colour_game_01_1_Jordan-India_After_one_week.eaf,2,1,24,166464,226582,60118,169443,169761,318,TONGUE,IX,,,FALSE
Colour_game_01_1_Jordan-India_After_one_week.eaf,2,1,24,166464,226582,60118,204968,205572,604,,IX,,,FALSE
Colour_game_01_1_Jordan-India_After_one_week.eaf,2,1,24,166464,226582,60118,205580,206455,875,RED,OS,Yes,,FALSE
Colour_game_01_1_Jordan-India_After_one_week.eaf,2,1,24,166464,226582,60118,206523,207190,667,SAME?,NA,,,FALSE
Colour_game_01_1_Jordan-India_After_one_week.eaf,2,1,24,166464,226582,60118,208752,209606,854,SIGNING,NA,,,FALSE
Colour_game_01_1_Jordan-India_After_one_week.eaf,2,1,24,166464,226582,60118,209606,210609,1003,COLOR,NA,,,FALSE
Colour_game_01_1_Jordan-India_After_one_week.eaf,2,1,24,166464,226582,60118,210913,212216,1303,JORDAN,NA,,,FALSE
Colour_game_01_1_Jordan-India_After_one_week.eaf,2,1,24,166464,226582,60118,212216,212696,480,INDIA,NA,,,FALSE
Colour_game_01_1_Jordan-India_After_one_week.eaf,2,1,24,166464,226582,60118,212696,212902,206,ME,NA,,,FALSE
Colour_game_01_1_Jordan-India_After_one_week.eaf,2,1,24,166464,226582,60118,212902,213228,326,JORDAN,NA,,,FALSE
Colour_game_01_1_Jordan-India_After_one_week.eaf,2,1,24,166464,226582,60118,213228,215141,1913,RED,OS,Yes,JSL,FALSE
Colour_game_01_1_Jordan-India_After_one_week.eaf,2,1,24,166464,226582,60118,218196,218477,281,FLOWER,LW,,,FALSE
Colour_game_01_1_Jordan-India_After_one_week.eaf,2,1,24,166464,226582,60118,218503,218690,187,NOT,NA,,,FALSE
Colour_game_01_1_Jordan-India_After_one_week.eaf,2,1,24,166464,226582,60118,218770,218963,193, i / M,IX,,,FALSE
Colour_game_01_1_Jordan-India_After_one_week.eaf,2,1,24,166464,226582,60118,219043,220091,1048,PINK,OS,No,JSL,FALSE
Colour_game_01_1_Jordan-India_After_one_week.eaf,2,1,24,166464,226582,60118,180244,180729,485,SAME,NA,NA,NA,TRUE
Colour_game_01_1_Jordan-India_After_one_week.eaf,2,1,24,166464,226582,60118,180783,183480,2697,FLOWER,LW,NA,NA,TRUE
Colour_game_01_1_Jordan-India_After_one_week.eaf,2,2,24,166464,226582,60118,166720,168620,1900,TONGUE,IX,Yes,,FALSE
Colour_game_01_1_Jordan-India_After_one_week.eaf,2,2,24,166464,226582,60118,168815,169241,426,BRIGHT,NA,,,FALSE
Colour_game_01_1_Jordan-India_After_one_week.eaf,2,2,24,166464,226582,60118,169443,169761,318,TONGUE,IX,Yes,,FALSE
Colour_game_01_1_Jordan-India_After_one_week.eaf,2,2,24,166464,226582,60118,170180,170395,215,TONGUE,IX,Yes,,FALSE
Colour_game_01_1_Jordan-India_After_one_week.eaf,2,2,24,166464,226582,60118,170558,171865,1307,RED,OS,Yes,,FALSE
Colour_game_01_1_Jordan-India_After_one_week.eaf,2,2,24,166464,226582,60118,171932,172423,491,LIPSTICK,NA,No,,FALSE
Colour_game_01_1_Jordan-India_After_one_week.eaf,2,2,24,166464,226582,60118,172423,173697,1274,RED,OS,Yes,,FALSE
Colour_game_01_1_Jordan-India_After_one_week.eaf,2,2,24,166464,226582,60118,173834,174229,395,RELATION,NA,,,FALSE
Colour_game_01_1_Jordan-India_After_one_week.eaf,2,2,24,166464,226582,60118,174249,174553,304,NOT,NA,,,FALSE
Colour_game_01_1_Jordan-India_After_one_week.eaf,2,2,24,166464,226582,60118,174627,174768,141,DIFFERENT,NA,,,FALSE
Colour_game_01_1_Jordan-India_After_one_week.eaf,2,2,24,166464,226582,60118,174851,175371,520,TONGUE,IX,Yes,,FALSE
Colour_game_01_1_Jordan-India_After_one_week.eaf,2,2,24,166464,226582,60118,175371,175680,309,LIP,IX,Yes,,FALSE
Colour_game_01_1_Jordan-India_After_one_week.eaf,2,2,24,166464,226582,60118,175726,176831,1105,DIFFERENT,NA,,,FALSE
Colour_game_01_1_Jordan-India_After_one_week.eaf,2,2,24,166464,226582,60118,176925,177364,439,TONGUE,IX,Yes,,FALSE
Colour_game_01_1_Jordan-India_After_one_week.eaf,2,2,24,166464,226582,60118,177564,177847,283,LIP,IX,Yes,,FALSE
Colour_game_01_1_Jordan-India_After_one_week.eaf,2,2,24,166464,226582,60118,179253,179516,263,TONGUE,IX,Yes,,FALSE
Colour_game_01_1_Jordan-India_After_one_week.eaf,2,2,24,166464,226582,60118,184604,185747,1143,RED,OS,,,FALSE
Colour_game_01_1_Jordan-India_After_one_week.eaf,2,2,24,166464,226582,60118,185747,186451,704,LIP,NA,,,FALSE
Colour_game_01_1_Jordan-India_After_one_week.eaf,2,2,24,166464,226582,60118,186457,186988,531,LIPSTICK,NA,,,FALSE
Colour_game_01_1_Jordan-India_After_one_week.eaf,2,2,24,166464,226582,60118,186992,187171,179,LIP,NA,,,FALSE
Colour_game_01_1_Jordan-India_After_one_week.eaf,2,2,24,166464,226582,60118,187171,187381,210,SIGNING,NA,,,FALSE
Colour_game_01_1_Jordan-India_After_one_week.eaf,2,2,24,166464,226582,60118,187640,187991,351,LIP,NA,,,FALSE
Colour_game_01_1_Jordan-India_After_one_week.eaf,2,2,24,166464,226582,60118,188132,188294,162,SIGINING,NA,,,FALSE
Colour_game_01_1_Jordan-India_After_one_week.eaf,2,2,24,166464,226582,60118,188423,189127,704,TONGUE,NA,Yes,,FALSE
Colour_game_01_1_Jordan-India_After_one_week.eaf,2,2,24,166464,226582,60118,189248,189581,333,SIGNING,NA,,,FALSE
Colour_game_01_1_Jordan-India_After_one_week.eaf,2,2,24,166464,226582,60118,189621,190294,673,TONGUE,IX,Yes,,FALSE
Colour_game_01_1_Jordan-India_After_one_week.eaf,2,2,24,166464,226582,60118,190443,190891,448,?,NA,,,FALSE
Colour_game_01_1_Jordan-India_After_one_week.eaf,2,2,24,166464,226582,60118,190891,191409,518,TONGUE,IX,Yes,,FALSE
Colour_game_01_1_Jordan-India_After_one_week.eaf,2,2,24,166464,226582,60118,191516,192007,491,SAME,NA,,,FALSE
Colour_game_01_1_Jordan-India_After_one_week.eaf,2,2,24,166464,226582,60118,192457,192826,369,FLOWER,LW,,,FALSE
Colour_game_01_1_Jordan-India_After_one_week.eaf,2,2,24,166464,226582,60118,192900,193719,819,SAME,NA,,,FALSE
Colour_game_01_1_Jordan-India_After_one_week.eaf,2,2,24,166464,226582,60118,193839,195416,1577,FLOWER,LW,Yes,,FALSE
Colour_game_01_1_Jordan-India_After_one_week.eaf,2,2,24,166464,226582,60118,195536,195711,175, I / ME,IX,,,FALSE
Colour_game_01_1_Jordan-India_After_one_week.eaf,2,2,24,166464,226582,60118,195831,196128,297,TONGUE,IX,,,FALSE
Colour_game_01_1_Jordan-India_After_one_week.eaf,2,2,24,166464,226582,60118,196248,196481,233,SIGNING,NA,,,FALSE
Colour_game_01_1_Jordan-India_After_one_week.eaf,2,2,24,166464,226582,60118,196561,197093,532,TONGUE,IX,Yes,,FALSE
Colour_game_01_1_Jordan-India_After_one_week.eaf,2,2,24,166464,226582,60118,198798,199467,669,RED(ISL),NA,,,FALSE
Colour_game_01_1_Jordan-India_After_one_week.eaf,2,2,24,166464,226582,60118,199600,199920,320,SAME,NA,,,FALSE
Colour_game_01_1_Jordan-India_After_one_week.eaf,2,2,24,166464,226582,60118,199920,200344,424,YES,NA,,,FALSE
Colour_game_01_1_Jordan-India_After_one_week.eaf,2,2,24,166464,226582,60118,200344,201028,684,RED(JSL),NA,,,FALSE
Colour_game_01_1_Jordan-India_After_one_week.eaf,2,2,24,166464,226582,60118,201028,201503,475,,NA,,,FALSE
Colour_game_01_1_Jordan-India_After_one_week.eaf,2,2,24,166464,226582,60118,201703,202071,368,RED(JSL),NA,,,FALSE
Colour_game_01_1_Jordan-India_After_one_week.eaf,2,2,24,166464,226582,60118,202071,202610,539,TONGUE,IX,Yes,,FALSE
Colour_game_01_1_Jordan-India_After_one_week.eaf,2,2,24,166464,226582,60118,202650,204129,1479,DIFFERENT,NA,,,FALSE
Colour_game_01_1_Jordan-India_After_one_week.eaf,2,2,24,166464,226582,60118,207768,208322,554,NOT,NA,,,FALSE
Colour_game_01_1_Jordan-India_After_one_week.eaf,2,2,24,166464,226582,60118,208344,209308,964,DIFFERENT,NA,,,FALSE
Colour_game_01_1_Jordan-India_After_one_week.eaf,2,2,24,166464,226582,60118,214720,215049,329,I / ME,NA,,,FALSE
Colour_game_01_1_Jordan-India_After_one_week.eaf,2,2,24,166464,226582,60118,215049,217013,1964,RED(ISL),NA,,,FALSE
Colour_game_01_1_Jordan-India_After_one_week.eaf,2,2,24,166464,226582,60118,221018,221171,153, I / ME,IX,,,FALSE
Colour_game_01_1_Jordan-India_After_one_week.eaf,2,2,24,166464,226582,60118,221530,222258,728, TONGUE,IX,Yes,,FALSE
Colour_game_01_1_Jordan-India_After_one_week.eaf,2,2,24,166464,226582,60118,222354,222676,322,FLOWER,LW,,,FALSE
Colour_game_01_1_Jordan-India_After_one_week.eaf,2,2,24,166464,226582,60118,222798,223489,691, TONGUE,IX,Yes,,FALSE
Colour_game_01_1_Jordan-India_After_one_week.eaf,2,2,24,166464,226582,60118,224179,224804,625,FOLWER,LW,Yes,,FALSE
Colour_game_01_1_Jordan-India_After_one_week.eaf,2,2,24,166464,226582,60118,224958,225280,322,YES,NA,,,FALSE
Colour_game_01_1_Jordan-India_After_one_week.eaf,2,1,15,2028919,2038869,9950,2034381,2035849,1468,DARK,NA,NA,NA,TRUE
Colour_game_01_1_Jordan-India_After_one_week.eaf,2,1,15,2028919,2038869,9950,2036509,2038636,2127,BROWN,OS#JSL,NA,NA,TRUE
Colour_game_01_1_Jordan-India_After_one_week.eaf,2,2,15,2028919,2038869,9950,2029050,2029812,762,BROWN,IX#ISL+NSL,Yes,ISL-NSL,FALSE
Colour_game_01_1_Jordan-India_After_one_week.eaf,2,2,15,2028919,2038869,9950,2029812,2031141,1329,DARK,NA,,,FALSE
Colour_game_01_1_Jordan-India_After_one_week.eaf,2,2,15,2028919,2038869,9950,2031152,2031709,557,BLACK,OS#ISL,Yes,ISL,FALSE
Colour_game_01_1_Jordan-India_After_one_week.eaf,2,2,15,2028919,2038869,9950,2031983,2034400,2417,DARK,NA,,,FALSE
Colour_game_01_1_Jordan-India_After_one_week.eaf,2,2,14,1765354,1769674,4320,1765478,1766503,1025,SAME,NA,,,FALSE
Colour_game_01_1_Jordan-India_After_one_week.eaf,2,2,14,1765354,1769674,4320,1766678,1767090,412,GREEN(ISL),NA,No,ISL,FALSE
Colour_game_01_1_Jordan-India_After_one_week.eaf,2,1,23,535400,797560,262160,548146,549898,1752,C#PEEL, CL,NA,NA,TRUE
Colour_game_01_1_Jordan-India_After_one_week.eaf,2,1,23,535400,797560,262160,562925,565411,2486,얼굴 돌리거나 or 피드백 부재,NA,NA,NA,TRUE
Colour_game_01_1_Jordan-India_After_one_week.eaf,2,1,23,535400,797560,262160,583843,586330,2487,T0?,NA,NA,NA,TRUE
Colour_game_01_1_Jordan-India_After_one_week.eaf,2,1,23,535400,797560,262160,598971,600338,1367,T0 (포도)그것이 무엇인가? 무엇인가?(Repeat),NA,NA,NA,TRUE
Colour_game_01_1_Jordan-India_After_one_week.eaf,2,1,23,535400,797560,262160,602398,605164,2766,,Repeat,NA,NA,TRUE
Colour_game_01_1_Jordan-India_After_one_week.eaf,2,2,23,535400,797560,262160,535400,797560,262160,,NA,,,FALSE
Colour_game_01_1_Jordan-India_After_one_week.eaf,2,2,7,58543,62497,3954,58518,60138,1620,BLACK,OS#ISL,Yes,ISL,FALSE
Colour_game_01_1_Jordan-India_After_one_week.eaf,2,2,7,58543,62497,3954,60140,61048,908,HAIR,NA,Yes,,FALSE
Colour_game_01_1_Jordan-India_After_one_week.eaf,2,2,7,58543,62497,3954,61134,62414,1280,BLACK,OS#ISL,Yes,ISL,FALSE
Colour_game_01_1_Jordan-India_After_one_week.eaf,2,1,18 ,1268261,1286861,18600,1282456,1283005,549,EAT,NA,NA,NA,TRUE
Colour_game_01_1_Jordan-India_After_one_week.eaf,2,1,18 ,1268261,1286861,18600,1283005,1283643,638,LEMON,LW,NA,NA,TRUE
Colour_game_01_1_Jordan-India_After_one_week.eaf,2,1,18 ,1268261,1286861,18600,1284140,1285979,1839,BRIGHT1,NA,NA,NA,TRUE
Colour_game_01_1_Jordan-India_After_one_week.eaf,2,2,18 ,1268261,1286861,18600,1270596,1271067,471,YELLOW,OS#ISL,No,ISL,FALSE
Colour_game_01_1_Jordan-India_After_one_week.eaf,2,2,18 ,1268261,1286861,18600,1273112,1273552,440,YELLOW,OS#ISL,No,ISL,FALSE
Colour_game_01_1_Jordan-India_After_one_week.eaf,2,2,18 ,1268261,1286861,18600,1273735,1274894,1159,LEMON,LW,Yes,,FALSE
Colour_game_01_1_Jordan-India_After_one_week.eaf,2,2,18 ,1268261,1286861,18600,1276142,1276600,458,SAME,NA,,,FALSE
Colour_game_01_1_Jordan-India_After_one_week.eaf,2,2,18 ,1268261,1286861,18600,1276600,1277064,464,L,fs,,,FALSE
Colour_game_01_1_Jordan-India_After_one_week.eaf,2,2,18 ,1268261,1286861,18600,1277624,1277846,222,SIGN,NA,,,FALSE
Colour_game_01_1_Jordan-India_After_one_week.eaf,2,2,18 ,1268261,1286861,18600,1277846,1278090,244,LEMON,NA,Yes,,FALSE
Colour_game_01_1_Jordan-India_After_one_week.eaf,2,2,18 ,1268261,1286861,18600,1278919,1279471,552,SUN,NA,Yes,,FALSE
Colour_game_01_1_Jordan-India_After_one_week.eaf,2,2,18 ,1268261,1286861,18600,1279578,1279885,307,DIFFERENT,NA,,,FALSE
Colour_game_01_1_Jordan-India_After_one_week.eaf,2,2,18 ,1268261,1286861,18600,1279911,1281176,1265,LEMON,LW,Yes,,FALSE
Colour_game_01_1_Jordan-India_After_one_week.eaf,2,2,18 ,1268261,1286861,18600,1281353,1281775,422,SAME,NA,,,FALSE
Colour_game_01_1_Jordan-India_After_one_week.eaf,2,2,18 ,1268261,1286861,18600,1281827,1282300,473,THAT,IX,,,FALSE
Colour_game_01_1_Jordan-India_After_one_week.eaf,2,2,18 ,1268261,1286861,18600,1283465,1285093,1628,FLOOR,IX,Yes,,FALSE
Colour_game_01_1_Jordan-India_After_one_week.eaf,2,2,18 ,1268261,1286861,18600,1285308,1285536,228,BRIGHT1,NA,,,FALSE
Colour_game_01_1_Jordan-India_After_one_week.eaf,2,1,12,1474596,1551896,77300,1490220,1496688,6468,SKY+SEA?,NA,NA,NA,TRUE
Colour_game_01_1_Jordan-India_After_one_week.eaf,2,1,12,1474596,1551896,77300,1497500,1504000,6500,첫째로 하늘 둘째 바다 셋째 어두운 것으로 셋째? ,NA,NA,NA,TRUE
Colour_game_01_1_Jordan-India_After_one_week.eaf,2,1,12,1474596,1551896,77300,1544628,1551250,6622,하얀색이라고 하지말아. 그냥 하늘색이지?,NA,NA,NA,TRUE
Colour_game_01_1_Jordan-India_After_one_week.eaf,2,2,12,1474596,1551896,77300,1474396,1485496,11100,하늘과 같은데.. 바다보다 더 밝은데 그건 하얀색을 더해서 나온 색,NA,,,FALSE
Colour_game_01_1_Jordan-India_After_one_week.eaf,2,2,12,1474596,1551896,77300,1486264,1493451,7187,POINTING(하늘),NA,,,FALSE
Colour_game_01_1_Jordan-India_After_one_week.eaf,2,2,12,1474596,1551896,77300,1527000,1542900,15900,3번째중에서 1째로 하늘 하얀 같은 색,NA,,,FALSE
Colour_game_01_1_Jordan-India_After_one_week.eaf,2,2,12,1474596,1551896,77300,1549500,1551553,2053,YES!,NA,,,FALSE
Colour_game_01_1_Jordan-India_After_one_week.eaf,2,2,6,84000,88900,4900,84577,86450,1873,WHITE,NA,,,FALSE
Colour_game_01_1_Nepal-Indonesia_After_one_week.eaf,1,1,1,1050483,1053580,3097,1050448,1053431,2983,RED,OS#NSL,Yes,NSL,FALSE
Colour_game_01_1_Nepal-Indonesia_After_one_week.eaf,1,1,16   몰래 16라고 알려줌 ㅋ,346594,397363,50769,349961,350966,1005,GREEN2,NA,,,FALSE
Colour_game_01_1_Nepal-Indonesia_After_one_week.eaf,1,1,16   몰래 16라고 알려줌 ㅋ,346594,397363,50769,352667,353064,397,TREE,NA,,,FALSE
Colour_game_01_1_Nepal-Indonesia_After_one_week.eaf,1,1,16   몰래 16라고 알려줌 ㅋ,346594,397363,50769,353064,353860,796,LEAF,NA,,,FALSE
Colour_game_01_1_Nepal-Indonesia_After_one_week.eaf,1,1,16   몰래 16라고 알려줌 ㅋ,346594,397363,50769,356362,361462,5100,DARK1#LITTLE,NA,,,FALSE
Colour_game_01_1_Nepal-Indonesia_After_one_week.eaf,1,1,16   몰래 16라고 알려줌 ㅋ,346594,397363,50769,361462,362084,622,BRIGHT1,NA,,,FALSE
Colour_game_01_1_Nepal-Indonesia_After_one_week.eaf,1,1,16   몰래 16라고 알려줌 ㅋ,346594,397363,50769,362084,362799,715,NO,NA,,,FALSE
Colour_game_01_1_Nepal-Indonesia_After_one_week.eaf,1,1,16   몰래 16라고 알려줌 ㅋ,346594,397363,50769,362799,364019,1220,DARK1,NA,,,FALSE
Colour_game_01_1_Nepal-Indonesia_After_one_week.eaf,1,1,16   몰래 16라고 알려줌 ㅋ,346594,397363,50769,367998,369446,1448,WALL,IX,,,FALSE
Colour_game_01_1_Nepal-Indonesia_After_one_week.eaf,1,1,16   몰래 16라고 알려줌 ㅋ,346594,397363,50769,369446,370672,1226,SAME,NA,,,FALSE
Colour_game_01_1_Nepal-Indonesia_After_one_week.eaf,1,1,16   몰래 16라고 알려줌 ㅋ,346594,397363,50769,370672,377203,6531,SAME2,NA,,,FALSE
Colour_game_01_1_Nepal-Indonesia_After_one_week.eaf,1,1,14,852094,862681,10587,852444,853301,857,GREEN,OS#NSL,No,NSL,FALSE
Colour_game_01_1_Nepal-Indonesia_After_one_week.eaf,1,1,14,852094,862681,10587,857791,861448,3657,GREEN,OS#NSL,No,NSL,FALSE
Colour_game_01_1_Nepal-Indonesia_After_one_week.eaf,1,2,14,852094,862681,10587,858490,860069,1579,REPEAT,NA,,NA,TRUE
Colour_game_01_1_Nepal-Indonesia_After_one_week.eaf,1,2,14,852094,862681,10587,860069,860783,714,PLANTS,LW,Yes,NA,TRUE
Colour_game_01_1_Nepal-Indonesia_After_one_week.eaf,1,2,14,852094,862681,10587,860826,861726,900,REPEAT,NA,,NA,TRUE
Colour_game_01_1_Nepal-Indonesia_After_one_week.eaf,1,1,5,1020025,1025228,5203,1020009,1022346,2337,BROWN,OS#ISL+NSL,,ISL+NSL,FALSE
Colour_game_01_1_Nepal-Indonesia_After_one_week.eaf,1,1,5,1020025,1025228,5203,1024014,1024864,850,DARK,NA,,,FALSE
Colour_game_01_1_Nepal-Indonesia_After_one_week.eaf,1,1,19  이해어려움,408270,467356,59086,408713,421413,12700,ORANGE JUICE,SE,Yes,,FALSE
Colour_game_01_1_Nepal-Indonesia_After_one_week.eaf,1,1,19  이해어려움,408270,467356,59086,421613,425613,4000,BRIGHT,NA,,,FALSE
Colour_game_01_1_Nepal-Indonesia_After_one_week.eaf,1,1,19  이해어려움,408270,467356,59086,425613,426200,587,DARK,NA,,,FALSE
Colour_game_01_1_Nepal-Indonesia_After_one_week.eaf,1,1,19  이해어려움,408270,467356,59086,437454,439000,1546,YELLOW,OS,No,NSL,FALSE
Colour_game_01_1_Nepal-Indonesia_After_one_week.eaf,1,1,19  이해어려움,408270,467356,59086,444820,446580,1760,NO,NA,,,FALSE
Colour_game_01_1_Nepal-Indonesia_After_one_week.eaf,1,1,19  이해어려움,408270,467356,59086,461780,464000,2220,PAINT THE WALL,LW,,,FALSE
Colour_game_01_1_Nepal-Indonesia_After_one_week.eaf,1,1,19  이해어려움,408270,467356,59086,464063,465763,1700,YELLOW,OS,Yes,NSL,FALSE
Colour_game_01_1_Nepal-Indonesia_After_one_week.eaf,1,2,19  이해어려움,408270,467356,59086,444100,445120,1020,RED,OS,Yes,NA,TRUE
Colour_game_01_1_Nepal-Indonesia_After_one_week.eaf,1,1,7,16597,19564,2967,17298,19655,2357,BLACK,OS#NSL,Yes,NSL,FALSE
Colour_game_01_1_Nepal-Indonesia_After_one_week.eaf,1,1,19,556104,572304,16200,556304,559204,2900,DRINK,LW,,,FALSE
Colour_game_01_1_Nepal-Indonesia_After_one_week.eaf,1,1,19,556104,572304,16200,560100,561737,1637,ORANGE?,LW,Yes,,FALSE
Colour_game_01_1_Nepal-Indonesia_After_one_week.eaf,1,1,19,556104,572304,16200,561737,563637,1900,NO,NA,,,FALSE
Colour_game_01_1_Nepal-Indonesia_After_one_week.eaf,1,1,19,556104,572304,16200,563637,564662,1025,BRIGHT,NA,,,FALSE
Colour_game_01_1_Nepal-Indonesia_After_one_week.eaf,1,1,19,556104,572304,16200,564662,566549,1887,SAME,NA,,,FALSE
Colour_game_01_1_Nepal-Indonesia_After_one_week.eaf,1,1,19,556104,572304,16200,570508,571058,550,YES,NA,,,FALSE
Colour_game_01_1_Nepal-Indonesia_After_one_week.eaf,1,2,19,556104,572304,16200,561544,562464,920,LITTER,LW,,NA,TRUE
Colour_game_01_1_Nepal-Indonesia_After_one_week.eaf,1,2,19,556104,572304,16200,565255,566521,1266,BRIGHT,NA,Yes,NA,TRUE
Colour_game_01_1_Nepal-Indonesia_After_one_week.eaf,1,2,19,556104,572304,16200,569783,571133,1350,SUN,LW,Yes,NA,TRUE
Colour_game_01_1_Nepal-Indonesia_After_one_week.eaf,1,1,20,486230,488287,2057,486259,488187,1928,RED,OS,Yes,NSL,FALSE
Colour_game_01_1_Nepal-Indonesia_After_one_week.eaf,1,1,19,69619,192119,122500,69666,72593,2927,YELLOW,OS,Yes,NSL,FALSE
Colour_game_01_1_Nepal-Indonesia_After_one_week.eaf,1,1,19,69619,192119,122500,80050,81950,1900,SAME,NA,,,FALSE
Colour_game_01_1_Nepal-Indonesia_After_one_week.eaf,1,1,19,69619,192119,122500,83796,88911,5115,EAT^PEEL,LW,Yes,,FALSE
Colour_game_01_1_Nepal-Indonesia_After_one_week.eaf,1,1,19,69619,192119,122500,88950,92700,3750,YELLOW,OS,Yes,NSL,FALSE
Colour_game_01_1_Nepal-Indonesia_After_one_week.eaf,1,1,19,69619,192119,122500,92817,93670,853,GREEN,OS,,ISL,FALSE
Colour_game_01_1_Nepal-Indonesia_After_one_week.eaf,1,1,19,69619,192119,122500,93670,94316,646,GREEN,OS,,NSL,FALSE
Colour_game_01_1_Nepal-Indonesia_After_one_week.eaf,1,1,19,69619,192119,122500,94336,94977,641,NO,NA,,,FALSE
Colour_game_01_1_Nepal-Indonesia_After_one_week.eaf,1,1,19,69619,192119,122500,94977,95603,626,SAME,NA,,,FALSE
Colour_game_01_1_Nepal-Indonesia_After_one_week.eaf,1,1,19,69619,192119,122500,96075,97325,1250,YELLOW,OS,Yes,NSL,FALSE
Colour_game_01_1_Nepal-Indonesia_After_one_week.eaf,1,1,19,69619,192119,122500,105200,123500,18300,EAT,SE,,,FALSE
Colour_game_01_1_Nepal-Indonesia_After_one_week.eaf,1,1,19,69619,192119,122500,125316,127399,2083,NO,NA,,,FALSE
Colour_game_01_1_Nepal-Indonesia_After_one_week.eaf,1,1,19,69619,192119,122500,132227,132861,634,GREEN,OS,No,NSL,FALSE
Colour_game_01_1_Nepal-Indonesia_After_one_week.eaf,1,1,19,69619,192119,122500,132902,133269,367,NO,NA,,,FALSE
Colour_game_01_1_Nepal-Indonesia_After_one_week.eaf,1,1,19,69619,192119,122500,133269,136094,2825,RING,IX,Yes,,FALSE
Colour_game_01_1_Nepal-Indonesia_After_one_week.eaf,1,1,19,69619,192119,122500,143919,146719,2800,NO,NA,,,FALSE
Colour_game_01_1_Nepal-Indonesia_After_one_week.eaf,1,1,19,69619,192119,122500,156619,159419,2800,YELLOW,OS,Yes,NSL,FALSE
Colour_game_01_1_Nepal-Indonesia_After_one_week.eaf,1,2,19,69619,192119,122500,74830,75070,240,THERE,IX,,NA,TRUE
Colour_game_01_1_Nepal-Indonesia_After_one_week.eaf,1,2,19,69619,192119,122500,75110,76330,1220,PLANTS,LW,Yes,NA,TRUE
Colour_game_01_1_Nepal-Indonesia_After_one_week.eaf,1,2,19,69619,192119,122500,76700,77199,499,GREEN,OS,No,NA,TRUE
Colour_game_01_1_Nepal-Indonesia_After_one_week.eaf,1,2,19,69619,192119,122500,77199,77932,733,NO?,NA,,NA,TRUE
Colour_game_01_1_Nepal-Indonesia_After_one_week.eaf,1,2,19,69619,192119,122500,85700,90600,4900,REPEAT,NA,,NA,TRUE
Colour_game_01_1_Nepal-Indonesia_After_one_week.eaf,1,2,19,69619,192119,122500,91500,94800,3300,REPEAT,NA,,NA,TRUE
Colour_game_01_1_Nepal-Indonesia_After_one_week.eaf,1,2,19,69619,192119,122500,124000,125600,1600,RED,OS,,NA,TRUE
Colour_game_01_1_Nepal-Indonesia_After_one_week.eaf,1,2,19,69619,192119,122500,129365,132149,2784,REPEAT,NA,,NA,TRUE
Colour_game_01_1_Nepal-Indonesia_After_one_week.eaf,1,2,19,69619,192119,122500,140069,144169,4100,LEMON,LW,Yes,NA,TRUE
Colour_game_01_1_Nepal-Indonesia_After_one_week.eaf,1,2,19,69619,192119,122500,148455,149100,645,THERE,IX,,NA,TRUE
Colour_game_01_1_Nepal-Indonesia_After_one_week.eaf,1,2,19,69619,192119,122500,149100,154267,5167,PLANTS,LW,,NA,TRUE
Colour_game_01_1_Nepal-Indonesia_After_one_week.eaf,1,2,19,69619,192119,122500,155193,156553,1360,REPEAT,NA,,NA,TRUE
Colour_game_01_1_Nepal-Indonesia_After_one_week.eaf,2,1,24,48594,62608,14014,52206,52731,525,RED,OS,Yes,NA,TRUE
Colour_game_01_1_Nepal-Indonesia_After_one_week.eaf,2,1,24,48594,62608,14014,52756,53856,1100,NO,NA,,NA,TRUE
Colour_game_01_1_Nepal-Indonesia_After_one_week.eaf,2,1,24,48594,62608,14014,53856,55181,1325,DARK,NA,,NA,TRUE
Colour_game_01_1_Nepal-Indonesia_After_one_week.eaf,2,2,24,48594,62608,14014,48582,50805,2223,FLOWER,LW,,,FALSE
Colour_game_01_1_Nepal-Indonesia_After_one_week.eaf,2,2,24,48594,62608,14014,54580,55877,1297,BRIGHT1,NA,,,FALSE
Colour_game_01_1_Nepal-Indonesia_After_one_week.eaf,2,2,24,48594,62608,14014,56998,57636,638,RED,OS#NSL,Yes,NSL,FALSE
Colour_game_01_1_Nepal-Indonesia_After_one_week.eaf,2,2,24,48594,62608,14014,57656,58160,504,RED,OS#NSL,Yes,NSL,FALSE
Colour_game_01_1_Nepal-Indonesia_After_one_week.eaf,2,2,24,48594,62608,14014,58167,59020,853,IX(RED),NA,,,FALSE
Colour_game_01_1_Nepal-Indonesia_After_one_week.eaf,2,2,24,48594,62608,14014,59020,60468,1448,OHTER,NA,,,FALSE
Colour_game_01_1_Nepal-Indonesia_After_one_week.eaf,2,2,24,48594,62608,14014,60535,62535,2000,BIGHT,NA,,,FALSE
Colour_game_01_1_Nepal-Indonesia_After_one_week.eaf,2,2,15,992613,1005114,12501,996058,996650,592,GREEN2(NSL),NA,,,FALSE
Colour_game_01_1_Nepal-Indonesia_After_one_week.eaf,2,2,15,992613,1005114,12501,996650,997232,582,DARK1#LITTLE,NA,,,FALSE
Colour_game_01_1_Nepal-Indonesia_After_one_week.eaf,2,2,23  (23이라고 알려줌 ㅋㅋ),192543,297501,104958,203316,204722,1406,RED,NA,,,FALSE
Colour_game_01_1_Nepal-Indonesia_After_one_week.eaf,2,2,23  (23이라고 알려줌 ㅋㅋ),192543,297501,104958,204722,206118,1396,SEA,NA,,,FALSE
Colour_game_01_1_Nepal-Indonesia_After_one_week.eaf,2,2,23  (23이라고 알려줌 ㅋㅋ),192543,297501,104958,206118,206502,384,COMBINE,NA,,,FALSE
Colour_game_01_1_Nepal-Indonesia_After_one_week.eaf,2,2,23  (23이라고 알려줌 ㅋㅋ),192543,297501,104958,206502,207786,1284,MIX,NA,,,FALSE
Colour_game_01_1_Nepal-Indonesia_After_one_week.eaf,2,2,23  (23이라고 알려줌 ㅋㅋ),192543,297501,104958,207786,208937,1151,DARK1#LITTLE,NA,,,FALSE
Colour_game_01_1_Nepal-Indonesia_After_one_week.eaf,2,2,23  (23이라고 알려줌 ㅋㅋ),192543,297501,104958,209989,210878,889,RED,NA,,,FALSE
Colour_game_01_1_Nepal-Indonesia_After_one_week.eaf,2,2,23  (23이라고 알려줌 ㅋㅋ),192543,297501,104958,210878,213062,2184,SEA,NA,,,FALSE
Colour_game_01_1_Nepal-Indonesia_After_one_week.eaf,2,2,23  (23이라고 알려줌 ㅋㅋ),192543,297501,104958,213062,214238,1176,WATER,NA,,,FALSE
Colour_game_01_1_Nepal-Indonesia_After_one_week.eaf,2,2,23  (23이라고 알려줌 ㅋㅋ),192543,297501,104958,214238,214954,716,COMBINE,NA,,,FALSE
Colour_game_01_1_Nepal-Indonesia_After_one_week.eaf,2,2,23  (23이라고 알려줌 ㅋㅋ),192543,297501,104958,214954,215816,862,MIX,NA,,,FALSE
Colour_game_01_1_Nepal-Indonesia_After_one_week.eaf,2,2,23  (23이라고 알려줌 ㅋㅋ),192543,297501,104958,215816,217227,1411,DARK1#LITTLE,NA,,,FALSE
Colour_game_01_1_Nepal-Indonesia_After_one_week.eaf,2,2,7,11333,12942,1609,11345,12932,1587,BLACK,OS#ISL,Yes,ISL,FALSE
Colour_game_01_2_Jordan-Indonesia_After_one_week.eaf,1,1,14,760920,772946,12026,761130,761882,752,PLANTS,LW,Yes,,FALSE
Colour_game_01_2_Jordan-Indonesia_After_one_week.eaf,1,1,14,760920,772946,12026,761882,763355,1473,GREEN,OS#ISL,No,ISL,FALSE
Colour_game_01_2_Jordan-Indonesia_After_one_week.eaf,1,1,14,760920,772946,12026,765139,765678,539,BOOGER,LW,Yes,,FALSE
Colour_game_01_2_Jordan-Indonesia_After_one_week.eaf,1,1,14,760920,772946,12026,765678,766829,1151,SECOND,IX,,,FALSE
Colour_game_01_2_Jordan-Indonesia_After_one_week.eaf,1,1,14,760920,772946,12026,766829,769186,2357,FIRST,NA,,,FALSE
Colour_game_01_2_Jordan-Indonesia_After_one_week.eaf,1,1,14,760920,772946,12026,769186,769676,490,BOOGER,LW,Yes,,FALSE
Colour_game_01_2_Jordan-Indonesia_After_one_week.eaf,1,1,14,760920,772946,12026,769676,770067,391,SECOND,NA,,,FALSE
Colour_game_01_2_Jordan-Indonesia_After_one_week.eaf,1,1,14,760920,772946,12026,770067,770262,195,NO,NA,,,FALSE
Colour_game_01_2_Jordan-Indonesia_After_one_week.eaf,1,1,14,760920,772946,12026,770262,770744,482,FIRST,NA,,,FALSE
Colour_game_01_2_Jordan-Indonesia_After_one_week.eaf,1,1,14,760920,772946,12026,770744,771438,694,GREEN,OS#ISL,No,ISL,FALSE
Colour_game_01_2_Jordan-Indonesia_After_one_week.eaf,1,1,14,760920,772946,12026,771438,771714,276,CORRECT,NA,,,FALSE
Colour_game_01_2_Jordan-Indonesia_After_one_week.eaf,1,1,14,760920,772946,12026,771714,772275,561,TREE,fs,,,FALSE
Colour_game_01_2_Jordan-Indonesia_After_one_week.eaf,1,1,14,760920,772946,12026,772275,772888,613,OUT,IX,,,FALSE
Colour_game_01_2_Jordan-Indonesia_After_one_week.eaf,1,2,14,760920,772946,12026,764298,765394,1096,WHAT,NA,NA,NA,TRUE
Colour_game_01_2_Jordan-Indonesia_After_one_week.eaf,1,2,14,760920,772946,12026,771779,772242,463,GREEN1,NA,NA,NA,TRUE
Colour_game_01_2_Jordan-Indonesia_After_one_week.eaf,1,2,14,760920,772946,12026,772242,773862,1620,CORRENT,NA,NA,NA,TRUE
Colour_game_01_2_Jordan-Indonesia_After_one_week.eaf,1,1,19,177276,180123,2847,177314,177934,620,SAME,NA,,,FALSE
Colour_game_01_2_Jordan-Indonesia_After_one_week.eaf,1,1,19,177276,180123,2847,177974,180074,2100,BOLD PATTRN OF DRESS,LW,Yes,,FALSE
Colour_game_01_2_Jordan-Indonesia_After_one_week.eaf,1,1,19,177276,180123,2847,180114,181154,1040,DARK,NA,,,FALSE
Colour_game_01_2_Jordan-Indonesia_After_one_week.eaf,1,1,5,625472,630586,5114,626180,627720,1540,SAME,NA,,,FALSE
Colour_game_01_2_Jordan-Indonesia_After_one_week.eaf,1,1,18,118731,130558,11827,118812,121360,2548,YELLOW,OS#ISL,No,ISL,FALSE
Colour_game_01_2_Jordan-Indonesia_After_one_week.eaf,1,1,18,118731,130558,11827,121360,123365,2005,BRIGHT,NA,,,FALSE
Colour_game_01_2_Jordan-Indonesia_After_one_week.eaf,1,1,18,118731,130558,11827,125081,125935,854,SAME,NA,,,FALSE
Colour_game_01_2_Jordan-Indonesia_After_one_week.eaf,1,1,18,118731,130558,11827,125935,128456,2521,LW:CAP(POLICE)'S LW:BOLD PATTRN OF DRESS,NA,,,FALSE
Colour_game_01_2_Jordan-Indonesia_After_one_week.eaf,1,1,18,118731,130558,11827,128456,129722,1266,DRIVE,LW,,,FALSE
Colour_game_01_2_Jordan-Indonesia_After_one_week.eaf,1,1,18,118731,130558,11827,129722,130498,776,BRIGHT,NA,,,FALSE
Colour_game_01_2_Jordan-Indonesia_After_one_week.eaf,2,1,7,161403,165995,4592,163159,165435,2276,PEPEAT,NA,NA,NA,TRUE
Colour_game_01_2_Jordan-Indonesia_After_one_week.eaf,2,1,7,161403,165995,4592,165435,165967,532,MOUTHING?,NA,NA,NA,TRUE
Colour_game_01_2_Jordan-Indonesia_After_one_week.eaf,2,2,7,161403,165995,4592,161403,162934,1531,BLACK,OS#INSL,Yes,INSL,FALSE
Colour_game_01_2_Jordan-Indonesia_After_one_week.eaf,2,2,7,161403,165995,4592,163000,164983,1983,BLACK,OS#INSL,Yes,INSL,FALSE
Colour_game_01_2_Jordan-Indonesia_After_one_week.eaf,2,1,5,588402,608442,20040,596921,597658,737,BROWN,OS#INSL,NA,NA,TRUE
Colour_game_01_2_Jordan-Indonesia_After_one_week.eaf,2,1,5,588402,608442,20040,597658,598973,1315,DARK,NA,NA,NA,TRUE
Colour_game_01_2_Jordan-Indonesia_After_one_week.eaf,2,1,5,588402,608442,20040,606907,608335,1428,WATCH,IX,NA,NA,TRUE
Colour_game_01_2_Jordan-Indonesia_After_one_week.eaf,2,2,5,588402,608442,20040,588690,590315,1625,BROWN,OS#INSL,Yes,INSL,FALSE
Colour_game_01_2_Jordan-Indonesia_After_one_week.eaf,2,2,5,588402,608442,20040,590527,592775,2248,dark,NA,,,FALSE
Colour_game_01_2_Jordan-Indonesia_After_one_week.eaf,2,2,5,588402,608442,20040,593042,595831,2789,BROWN,OS#INSL,Yes,INSL,FALSE
Colour_game_01_2_Jordan-Indonesia_After_one_week.eaf,2,2,5,588402,608442,20040,596300,597040,740,face,NA,Yes,,FALSE
Colour_game_01_2_Jordan-Indonesia_After_one_week.eaf,2,2,5,588402,608442,20040,601796,602278,482,SAME,NA,,,FALSE
Colour_game_01_2_Jordan-Indonesia_After_one_week.eaf,2,2,5,588402,608442,20040,602278,603477,1199,SIWASH,LW,Yes,,FALSE
Colour_game_01_2_Jordan-Indonesia_After_one_week.eaf,2,2,5,588402,608442,20040,603477,604626,1149,FACE#DARK,IX,,,FALSE
Colour_game_01_2_Jordan-Indonesia_After_one_week.eaf,2,1,24,501050,518050,17000,507881,509591,1710,RED,OS#INSL+JSL,NA,NA,TRUE
Colour_game_01_2_Jordan-Indonesia_After_one_week.eaf,2,1,24,501050,518050,17000,513403,513847,444,SAME,NA,NA,NA,TRUE
Colour_game_01_2_Jordan-Indonesia_After_one_week.eaf,2,1,24,501050,518050,17000,513872,516139,2267,FLOWER,LW,NA,NA,TRUE
Colour_game_01_2_Jordan-Indonesia_After_one_week.eaf,2,2,24,501050,518050,17000,502460,508855,6395,CLOWN,LW,Yes,,FALSE
Colour_game_01_2_Jordan-Indonesia_After_one_week.eaf,2,2,24,501050,518050,17000,510012,511328,1316,RED,OS#INSL+JSL,Yes,INSL+JSL,FALSE
Colour_game_01_2_Jordan-Indonesia_After_one_week.eaf,2,2,24,501050,518050,17000,511407,513776,2369,BRIGHT,NA,,,FALSE
Colour_game_01_2_Jordan-Indonesia_After_one_week.eaf,2,2,20,754155,755408,1253,754161,755406,1245,RED,OS,Yes,JSL,FALSE
Colour_game_01_2_Jordan-Indonesia_After_one_week.eaf,2,1,15,210400,381418,171018,258000,260100,2100,WALL,IX,NA,NA,TRUE
Colour_game_01_2_Jordan-Indonesia_After_one_week.eaf,2,1,15,210400,381418,171018,368307,375323,7016,GREEN1,OS,NA,NA,TRUE
Colour_game_01_2_Jordan-Indonesia_After_one_week.eaf,2,2,15,210400,381418,171018,213330,214680,1350,PLANTS,LW,Yes,,FALSE
Colour_game_01_2_Jordan-Indonesia_After_one_week.eaf,2,2,15,210400,381418,171018,214680,215246,566,DARK(VERY LITTLE),NA,,,FALSE
Colour_game_01_2_Jordan-Indonesia_After_one_week.eaf,2,2,15,210400,381418,171018,215246,216856,1610,FIRST,NA,,,FALSE
Colour_game_01_2_Jordan-Indonesia_After_one_week.eaf,2,2,15,210400,381418,171018,216856,218751,1895,BRIGHT,NA,,,FALSE
Colour_game_01_2_Jordan-Indonesia_After_one_week.eaf,2,2,15,210400,381418,171018,236862,237284,422,FIRST,NA,,,FALSE
Colour_game_01_2_Jordan-Indonesia_After_one_week.eaf,2,2,15,210400,381418,171018,237284,238387,1103,BRIGHT,NA,,,FALSE
Colour_game_01_2_Jordan-Indonesia_After_one_week.eaf,2,2,15,210400,381418,171018,238387,239743,1356,SECOND,NA,,,FALSE
Colour_game_01_2_Jordan-Indonesia_After_one_week.eaf,2,2,15,210400,381418,171018,239743,240539,796,CORRECT,NA,,,FALSE
Colour_game_01_2_Jordan-Indonesia_After_one_week.eaf,2,2,15,210400,381418,171018,241212,242897,1685,PLANTS,LW,Yes,,FALSE
Colour_game_01_2_Jordan-Indonesia_After_one_week.eaf,2,2,15,210400,381418,171018,242897,243548,651,CORRECT,NA,,,FALSE
Colour_game_01_2_Jordan-Indonesia_After_one_week.eaf,2,2,15,210400,381418,171018,256051,257425,1374,THIRD,NA,,,FALSE
Colour_game_01_2_Jordan-Indonesia_After_one_week.eaf,2,2,15,210400,381418,171018,257425,259039,1614,DARK1,NA,,,FALSE
Colour_game_01_2_Jordan-Indonesia_After_one_week.eaf,2,2,15,210400,381418,171018,259039,259375,336,NO,NA,,,FALSE
Colour_game_01_2_Jordan-Indonesia_After_one_week.eaf,2,2,15,210400,381418,171018,259375,260055,680,YES,NA,,,FALSE
Colour_game_01_2_Jordan-Indonesia_After_one_week.eaf,2,2,15,210400,381418,171018,260055,261120,1065,DARK,NA,,,FALSE
Colour_game_01_2_Jordan-Indonesia_After_one_week.eaf,2,2,15,210400,381418,171018,261545,262404,859,DARK#LITTLE,NA,,,FALSE
Colour_game_01_2_Jordan-Indonesia_After_one_week.eaf,2,2,15,210400,381418,171018,262404,262832,428,FOURTHLY,NA,,,FALSE
Colour_game_01_2_Jordan-Indonesia_After_one_week.eaf,2,2,15,210400,381418,171018,262832,264347,1515,DARK(완전히),NA,,,FALSE
Colour_game_01_2_Jordan-Indonesia_After_one_week.eaf,2,2,15,210400,381418,171018,372498,376542,4044,GREEN1(ISL),NA,,,FALSE
Colour_game_01_2_Jordan-Indonesia_After_one_week.eaf,2,2,1,135972,138137,2165,136420,137880,1460,BLOOD,LW,Yes,,FALSE
Colour_game_01_2_Nepal-India_After_one_week.eaf,1,1,18,455190,459303,4113,455206,456052,846,YELLOW,OS#NSL,No,NSL,FALSE
Colour_game_01_2_Nepal-India_After_one_week.eaf,1,1,18,455190,459303,4113,456052,457726,1674,LEMON,LW,Yes,,FALSE
Colour_game_01_2_Nepal-India_After_one_week.eaf,1,1,18,455190,459303,4113,457808,459269,1461,BRIGHT,NA,Yes,,FALSE
Colour_game_01_2_Nepal-India_After_one_week.eaf,1,1,3,684101,686984,2883,684139,686945,2806,RED,OS,Yes,NSL,FALSE
Colour_game_01_2_Nepal-India_After_one_week.eaf,1,1,16,1005268,1007894,2626,1005533,1006706,1173,GREEN,OS,No,NSL,FALSE
Colour_game_01_2_Nepal-India_After_one_week.eaf,1,1,16,1005268,1007894,2626,1006706,1007823,1117,WALL,IX,Yes,,FALSE
Colour_game_01_2_Nepal-India_After_one_week.eaf,1,1,19,81622,86902,5280,81672,82241,569,LEMON,LW,Yes,,FALSE
Colour_game_01_2_Nepal-India_After_one_week.eaf,1,1,19,81622,86902,5280,82258,82637,379,KNOW,NA,,,FALSE
Colour_game_01_2_Nepal-India_After_one_week.eaf,1,1,19,81622,86902,5280,82645,83542,897,LEMON,LW,Yes,,FALSE
Colour_game_01_2_Nepal-India_After_one_week.eaf,1,1,19,81622,86902,5280,84119,84774,655,BRIGHT,NA,Yes,,FALSE
Colour_game_01_2_Nepal-India_After_one_week.eaf,1,1,19,81622,86902,5280,84774,86921,2147,DARK,NA,Yes,,FALSE
Colour_game_01_2_Nepal-India_After_one_week.eaf,1,1,18,10583,24166,13583,10570,12810,2240,YELLOW,OS#NSL,No,NSL,FALSE
Colour_game_01_2_Nepal-India_After_one_week.eaf,1,1,18,10583,24166,13583,12810,13440,630,GREEN,OS#ISL,No,ISL,FALSE
Colour_game_01_2_Nepal-India_After_one_week.eaf,1,1,18,10583,24166,13583,13440,13942,502,GREEN,OS#NSL,No,NSL,FALSE
Colour_game_01_2_Nepal-India_After_one_week.eaf,1,1,18,10583,24166,13583,13942,15063,1121,NO,NA,,,FALSE
Colour_game_01_2_Nepal-India_After_one_week.eaf,1,1,18,10583,24166,13583,15063,15442,379,OUT,IX,,,FALSE
Colour_game_01_2_Nepal-India_After_one_week.eaf,1,1,18,10583,24166,13583,15442,16035,593,TREE,LW,Yes,,FALSE
Colour_game_01_2_Nepal-India_After_one_week.eaf,1,1,18,10583,24166,13583,16035,16560,525,GREEN,OS#NSL,No,NSL,FALSE
Colour_game_01_2_Nepal-India_After_one_week.eaf,1,1,18,10583,24166,13583,16560,17163,603,NO,NA,,,FALSE
Colour_game_01_2_Nepal-India_After_one_week.eaf,1,1,18,10583,24166,13583,17163,17501,338,YELLOW,OS#NSL,Yes,NSL,FALSE
Colour_game_01_2_Nepal-India_After_one_week.eaf,1,1,18,10583,24166,13583,17501,18582,1081,COLOR,NA,,,FALSE
Colour_game_01_2_Nepal-India_After_one_week.eaf,1,1,18,10583,24166,13583,18582,20679,2097,BRIGHT,NA,,,FALSE
Colour_game_01_2_Nepal-India_After_one_week.eaf,1,2,18,10583,24166,13583,12304,13730,1426,GREEN,OS#ISL,No,NA,TRUE
Colour_game_01_2_Nepal-India_After_one_week.eaf,1,2,18,10583,24166,13583,21482,24112,2630,GREEN,OS#ISL,No,NA,TRUE
Colour_game_01_2_Nepal-India_After_one_week.eaf,1,1,3,1083314,1085290,1976,1083360,1085290,1930,RED,OS,Yes,NSL,FALSE
Colour_game_01_2_Nepal-India_After_one_week.eaf,2,1,1,25965,36029,10064,33480,35066,1586,BLOOD,LW,Yes,NA,TRUE
Colour_game_01_2_Nepal-India_After_one_week.eaf,2,2,1,25965,36029,10064,26340,26986,646,RED,OS#NSL,Yes,NSL,FALSE
Colour_game_01_2_Nepal-India_After_one_week.eaf,2,2,1,25965,36029,10064,27164,27864,700,RED,OS#INSL+JSL,Yes,INSL+JSL,FALSE
Colour_game_01_2_Nepal-India_After_one_week.eaf,2,2,1,25965,36029,10064,27864,28526,662,RED,OS#INSL+JSL,Yes,INSL+JSL,FALSE
Colour_game_01_2_Nepal-India_After_one_week.eaf,2,2,1,25965,36029,10064,28526,28955,429,RED,OS#NSL,Yes,NSL,FALSE
Colour_game_01_2_Nepal-India_After_one_week.eaf,2,2,1,25965,36029,10064,28955,30271,1316,,NA,,,FALSE
Colour_game_01_2_Nepal-India_After_one_week.eaf,2,2,1,25965,36029,10064,30271,30685,414,RED,OS#INSL+JSL,Yes,INSL+JSL,FALSE
Colour_game_01_2_Nepal-India_After_one_week.eaf,2,2,1,25965,36029,10064,30685,31658,973,RED,OS#INSL+JSL,Yes,INSL+JSL,FALSE
Colour_game_01_2_Nepal-India_After_one_week.eaf,2,2,1,25965,36029,10064,31658,33533,1875,RED,OS#NSL,Yes,NSL,FALSE
Colour_game_01_2_Nepal-India_After_one_week.eaf,2,2,1,25965,36029,10064,34879,35179,300,BLOOD,LW,Yes,,FALSE
Colour_game_01_2_Nepal-India_After_one_week.eaf,2,2,7,59146,60906,1760,59168,60878,1710,BLACK,OS#ISL,Yes,ISL,FALSE
Colour_game_01_2_Nepal-India_After_one_week.eaf,2,1,5,813538,829181,15643,816877,817087,210,BRIGHT,NA,,NA,TRUE
Colour_game_01_2_Nepal-India_After_one_week.eaf,2,1,5,813538,829181,15643,817087,818017,930,DARK,NA,,NA,TRUE
Colour_game_01_2_Nepal-India_After_one_week.eaf,2,2,5,813538,829181,15643,813675,814289,614,BROWN,OS#ISL+NSL,Yes,ISL+NSL,FALSE
Colour_game_01_2_Nepal-India_After_one_week.eaf,2,2,5,813538,829181,15643,815318,820077,4759,BROWN,OS#ISL+NSL,Yes,ISL+NSL,FALSE
Colour_game_01_2_Nepal-India_After_one_week.eaf,2,2,5,813538,829181,15643,823890,828338,4448,TREE-POST,LW,,,FALSE
Colour_game_01_2_Nepal-India_After_one_week.eaf,2,2,5,813538,829181,15643,828413,829251,838,BROWN,OS#ISL+NSL,Yes,ISL+NSL,FALSE
Colour_game_01_2_Nepal-India_After_one_week.eaf,2,1,24,657634,673354,15720,671486,672686,1200,FLOWER,LW,,NA,TRUE
Colour_game_01_2_Nepal-India_After_one_week.eaf,2,2,24,657634,673354,15720,657684,659284,1600,RED,OS#INSL+JSL,Yes,INSL+JSL,FALSE
Colour_game_01_2_Nepal-India_After_one_week.eaf,2,2,24,657634,673354,15720,659694,660874,1180,TONGUE,IX,Yes,,FALSE
Colour_game_01_2_Nepal-India_After_one_week.eaf,2,2,24,657634,673354,15720,660914,661274,360,DIFFERENT,NA,,,FALSE
Colour_game_01_2_Nepal-India_After_one_week.eaf,2,2,24,657634,673354,15720,661324,662944,1620,TONGUE,IX,Yes,,FALSE
Colour_game_01_2_Nepal-India_After_one_week.eaf,2,2,24,657634,673354,15720,663024,663344,320,SAME,NA,,,FALSE
Colour_game_01_2_Nepal-India_After_one_week.eaf,2,2,24,657634,673354,15720,663414,665294,1880,FLOWER,LW,,,FALSE
Colour_game_01_2_Nepal-India_After_one_week.eaf,2,2,24,657634,673354,15720,665304,665798,494,TONGUE,IX,,,FALSE
Colour_game_01_2_Nepal-India_After_one_week.eaf,2,2,24,657634,673354,15720,665798,666374,576,SAME,NA,,,FALSE
Colour_game_01_2_Nepal-India_After_one_week.eaf,2,2,24,657634,673354,15720,666396,667616,1220,FLOWER,LW,,,FALSE
Colour_game_01_2_Nepal-India_After_one_week.eaf,2,2,24,657634,673354,15720,669684,669884,200,TONGUE,IX,,,FALSE
Colour_game_01_2_Nepal-India_After_one_week.eaf,2,2,24,657634,673354,15720,669884,670974,1090,SAME,NA,,,FALSE
Colour_game_01_2_Nepal-India_After_one_week.eaf,2,2,24,657634,673354,15720,670974,673339,2365,FLOWER,LW,,,FALSE
Colour_game_01_2_Nepal-India_After_one_week.eaf,2,2,20,696018,697390,1372,696015,696671,656,RED,OS,Yes,JSL,FALSE
Colour_game_01_2_Nepal-India_After_one_week.eaf,2,2,20,696018,697390,1372,696671,697296,625,RED,OS,Yes,NSL,FALSE
Colour_game_01_2_Nepal-India_After_one_week.eaf,2,2,14,431399,441378,9979,432044,432835,791,GREEN,OS,No,ISL,FALSE
Colour_game_01_2_Nepal-India_After_one_week.eaf,2,2,14,431399,441378,9979,432835,434185,1350,BLOOD,IX,Yes,,FALSE
Colour_game_01_2_Nepal-India_After_one_week.eaf,2,2,14,431399,441378,9979,436150,436623,473,GREEN,OS,No,ISL,FALSE
Colour_game_01_2_Nepal-India_After_one_week.eaf,2,2,14,431399,441378,9979,436623,436945,322,SAME,NA,,,FALSE
Colour_game_01_2_Nepal-India_After_one_week.eaf,2,2,14,431399,441378,9979,436945,438041,1096,BLOOD,IX,Yes,,FALSE
Colour_game_01_2_Nepal-India_After_one_week.eaf,2,2,14,431399,441378,9979,438952,439343,391,THERE,IX,,,FALSE
Colour_game_01_2_Nepal-India_After_one_week.eaf,2,2,14,431399,441378,9979,439358,439661,303,TREE,NA,Yes,,FALSE
Colour_game_01_2_Nepal-India_After_one_week.eaf,2,2,14,431399,441378,9979,439661,440857,1196,DIFFERENT,NA,,,FALSE
Colour_game_01_2_Nepal-India_After_one_week.eaf,2,2,12,186455,205335,18880,191169,192004,835,,NA,,,FALSE
Colour_game_01_2_Nepal-India_After_one_week.eaf,2,2,12,186455,205335,18880,192245,192611,366,SAME,NA,,,FALSE
Colour_game_01_2_Nepal-India_After_one_week.eaf,2,2,12,186455,205335,18880,192611,192934,323,SKY,IX,,,FALSE
Colour_game_01_2_Nepal-India_After_one_week.eaf,2,2,12,186455,205335,18880,192934,194177,1243,SKY,NA,,,FALSE
Colour_game_01_2_Nepal-India_After_one_week.eaf,2,2,12,186455,205335,18880,196151,197341,1190,SAME,NA,,,FALSE
Colour_game_01_2_Nepal-India_After_one_week.eaf,2,2,12,186455,205335,18880,197341,198173,832,,NA,,,FALSE
Colour_game_01_2_Nepal-India_After_one_week.eaf,2,2,12,186455,205335,18880,199133,199427,294,SEA,NA,,,FALSE
Colour_game_01_2_Nepal-India_After_one_week.eaf,2,2,12,186455,205335,18880,199427,200422,995,DARK,NA,,,FALSE
Colour_game_01_2_Nepal-India_After_one_week.eaf,2,2,12,186455,205335,18880,200527,201208,681,NOT,NA,,,FALSE
Colour_game_01_2_Nepal-India_After_one_week.eaf,2,2,12,186455,205335,18880,201773,202201,428,,IX,,,FALSE
Colour_game_01_2_Nepal-India_After_one_week.eaf,2,2,12,186455,205335,18880,202201,202841,640,DARK,NA,,,FALSE
Colour_game_01_2_Nepal-India_After_one_week.eaf,2,2,12,186455,205335,18880,202841,203172,331,NOT,NA,,,FALSE
Colour_game_01_2_Nepal-India_After_one_week.eaf,2,2,12,186455,205335,18880,203172,203514,342,SKY,IX,,,FALSE
Colour_game_01_2_Nepal-India_After_one_week.eaf,2,2,12,186455,205335,18880,203514,204013,499,SAME,NA,,,FALSE
Colour_game_01_2_Nepal-India_After_one_week.eaf,2,2,12,186455,205335,18880,204613,205321,708,SKY,NA,,,FALSE
Colour_game_01_3_Indonesia-India_After_one_week.eaf,1,1,1,307067,311233,4166,307123,308504,1381,RED,OS#NSL,Yes,NSL,FALSE
Colour_game_01_3_Indonesia-India_After_one_week.eaf,1,1,1,307067,311233,4166,309893,310393,500,RED,OS#INSL+JSL,Yes,INSL+JSL,FALSE
Colour_game_01_3_Indonesia-India_After_one_week.eaf,1,1,1,307067,311233,4166,310426,311183,757,LIGHT,NA,,,FALSE
Colour_game_01_3_Indonesia-India_After_one_week.eaf,1,1,,791200,832900,41700,791652,793844,2192,GREEN,OS,No,ISL,FALSE
Colour_game_01_3_Indonesia-India_After_one_week.eaf,1,1,,791200,832900,41700,801905,808066,6161,4번째중1번째 ,NA,,,FALSE
Colour_game_01_3_Indonesia-India_After_one_week.eaf,1,1,,791200,832900,41700,808066,809370,1304,BRIGHT,NA,,,FALSE
Colour_game_01_3_Indonesia-India_After_one_week.eaf,1,1,,791200,832900,41700,809370,809721,351,SAME,NA,,,FALSE
Colour_game_01_3_Indonesia-India_After_one_week.eaf,1,1,,791200,832900,41700,809721,810256,535,WALL,IX,Yes,,FALSE
Colour_game_01_3_Indonesia-India_After_one_week.eaf,1,1,,791200,832900,41700,810256,810413,157,SAME,NA,,,FALSE
Colour_game_01_3_Indonesia-India_After_one_week.eaf,1,1,,791200,832900,41700,810413,811619,1206,4번째중1번째,NA,,,FALSE
Colour_game_01_3_Indonesia-India_After_one_week.eaf,1,1,,791200,832900,41700,811619,814237,2618,4번째중2번째,NA,,,FALSE
Colour_game_01_3_Indonesia-India_After_one_week.eaf,1,1,,791200,832900,41700,814237,815504,1267, CORRECT,NA,,,FALSE
Colour_game_01_3_Indonesia-India_After_one_week.eaf,1,1,,791200,832900,41700,815506,816656,1150,3번째,NA,,,FALSE
Colour_game_01_3_Indonesia-India_After_one_week.eaf,1,1,,791200,832900,41700,816656,818039,1383,DARK#LITTLE,NA,,,FALSE
Colour_game_01_3_Indonesia-India_After_one_week.eaf,1,1,,791200,832900,41700,818039,818535,496,4번째,NA,,,FALSE
Colour_game_01_3_Indonesia-India_After_one_week.eaf,1,1,,791200,832900,41700,818535,819701,1166,DARK,NA,,,FALSE
Colour_game_01_3_Indonesia-India_After_one_week.eaf,1,1,,791200,832900,41700,819753,820352,599,2번째,NA,,,FALSE
Colour_game_01_3_Indonesia-India_After_one_week.eaf,1,1,,791200,832900,41700,821497,822081,584,SAME,NA,,,FALSE
Colour_game_01_3_Indonesia-India_After_one_week.eaf,1,1,,791200,832900,41700,822081,823467,1386,BOGEER,LW,Yes,,FALSE
Colour_game_01_3_Indonesia-India_After_one_week.eaf,1,1,,791200,832900,41700,823467,824904,1437,3번째,NA,,,FALSE
Colour_game_01_3_Indonesia-India_After_one_week.eaf,1,1,,791200,832900,41700,827664,827845,181,2번째,NA,,,FALSE
Colour_game_01_3_Indonesia-India_After_one_week.eaf,1,1,,791200,832900,41700,827845,828291,446,SAME,NA,,,FALSE
Colour_game_01_3_Indonesia-India_After_one_week.eaf,1,1,,791200,832900,41700,828291,828467,176,OUT,IX,,,FALSE
Colour_game_01_3_Indonesia-India_After_one_week.eaf,1,1,,791200,832900,41700,828467,830173,1706,PLANTS,LW,Yes,,FALSE
Colour_game_01_3_Indonesia-India_After_one_week.eaf,1,1,20,579382,581978,2596,579458,581013,1555,RED,OS,Yes,ISL,FALSE
Colour_game_01_3_Indonesia-India_After_one_week.eaf,1,1,20,579382,581978,2596,581695,582018,323,RED,OS,Yes,ISL,FALSE
Colour_game_01_3_Indonesia-India_After_one_week.eaf,1,2,20,579382,581978,2596,580988,581665,677,RED,OS,NA,NA,TRUE
Colour_game_01_3_Indonesia-India_After_one_week.eaf,1,1,16,544051,556889,12838,544048,544661,613,GREEN,OS,No,ISL,FALSE
Colour_game_01_3_Indonesia-India_After_one_week.eaf,1,1,16,544051,556889,12838,544661,546156,1495,BRIGHT1,NA,,,FALSE
Colour_game_01_3_Indonesia-India_After_one_week.eaf,1,2,16,544051,556889,12838,546156,547043,887,BRIGHT1,NA,NA,NA,TRUE
Colour_game_01_3_Indonesia-India_After_one_week.eaf,1,2,16,544051,556889,12838,547043,547705,662,GREEN,OS,NA,NA,TRUE
Colour_game_01_3_Indonesia-India_After_one_week.eaf,1,2,16,544051,556889,12838,553252,553804,552,WHITE,NA,NA,NA,TRUE
Colour_game_01_3_Indonesia-India_After_one_week.eaf,1,2,16,544051,556889,12838,553804,554222,418,APPLY,NA,NA,NA,TRUE
Colour_game_01_3_Indonesia-India_After_one_week.eaf,1,2,16,544051,556889,12838,554222,555533,1311,BRIGHT,NA,NA,NA,TRUE
Colour_game_01_3_Indonesia-India_After_one_week.eaf,1,2,16,544051,556889,12838,555540,555756,216,SAME,NA,NA,NA,TRUE
Colour_game_01_3_Indonesia-India_After_one_week.eaf,1,2,16,544051,556889,12838,555756,556808,1052,WALL,IX,NA,NA,TRUE
Colour_game_01_3_Indonesia-India_After_one_week.eaf,1,1,24,430684,433664,2980,430764,433564,2800,FLOWER,LW,,,FALSE
Colour_game_01_3_Indonesia-India_After_one_week.eaf,1,1,19,935242,941813,6571,935350,939450,4100,LEMON,LW,Yes,,FALSE
Colour_game_01_3_Indonesia-India_After_one_week.eaf,1,1,19,935242,941813,6571,939450,941550,2100,BRIGHT,NA,Yes,,FALSE
Colour_game_01_3_Indonesia-India_After_one_week.eaf,1,1,14,136193,137801,1608,136464,136974,510,GREEN,OS#ISL,No,ISL,FALSE
Colour_game_01_3_Indonesia-India_After_one_week.eaf,1,1,14,136193,137801,1608,136974,137630,656,CORRECT,NA,,,FALSE
Colour_game_01_3_Indonesia-India_After_one_week.eaf,1,2,14,136193,137801,1608,137630,138321,691,GREEN1-1,NA,NA,NA,TRUE
Colour_game_01_3_Indonesia-India_After_one_week.eaf,1,1,18,1003624,1010214,6590,1003645,1004319,674,YELLOW,OS#ISL,No,ISL,FALSE
Colour_game_01_3_Indonesia-India_After_one_week.eaf,1,1,18,1003624,1010214,6590,1004319,1005060,741,BRIGHT,NA,,,FALSE
Colour_game_01_3_Indonesia-India_After_one_week.eaf,1,1,18,1003624,1010214,6590,1007713,1008394,681,SKY,IX,,,FALSE
Colour_game_01_3_Indonesia-India_After_one_week.eaf,1,1,18,1003624,1010214,6590,1008394,1008884,490,SUN,LW,Yes,,FALSE
Colour_game_01_3_Indonesia-India_After_one_week.eaf,1,1,18,1003624,1010214,6590,1008884,1010190,1306,BRIGHT,NA,,,FALSE
Colour_game_01_3_Indonesia-India_After_one_week.eaf,1,2,18,1003624,1010214,6590,1005911,1006071,160,YELLOW,OS#ISL,NA,NA,TRUE
Colour_game_01_3_Indonesia-India_After_one_week.eaf,1,2,18,1003624,1010214,6590,1006296,1007142,846,BRIGHT?,NA,NA,NA,TRUE
Colour_game_01_3_Indonesia-India_After_one_week.eaf,2,1,5,661229,697279,36050,670201,672901,2700,REPEAT,NA,NA,NA,TRUE
Colour_game_01_3_Indonesia-India_After_one_week.eaf,2,1,5,661229,697279,36050,675106,675397,291,IX SKIN,NA,NA,NA,TRUE
Colour_game_01_3_Indonesia-India_After_one_week.eaf,2,1,5,661229,697279,36050,675397,677326,1929,DARK,NA,NA,NA,TRUE
Colour_game_01_3_Indonesia-India_After_one_week.eaf,2,1,5,661229,697279,36050,678700,680900,2200,SKIN,IX,NA,NA,TRUE
Colour_game_01_3_Indonesia-India_After_one_week.eaf,2,1,5,661229,697279,36050,681405,682476,1071,DARK,NA,NA,NA,TRUE
Colour_game_01_3_Indonesia-India_After_one_week.eaf,2,1,5,661229,697279,36050,683604,686090,2486,DARK#FACE,NA,NA,NA,TRUE
Colour_game_01_3_Indonesia-India_After_one_week.eaf,2,1,5,661229,697279,36050,687497,688013,516,THERE,IX,NA,NA,TRUE
Colour_game_01_3_Indonesia-India_After_one_week.eaf,2,1,5,661229,697279,36050,688013,688639,626,SAME,NA,NA,NA,TRUE
Colour_game_01_3_Indonesia-India_After_one_week.eaf,2,1,5,661229,697279,36050,688639,689758,1119,THERE,IX,NA,NA,TRUE
Colour_game_01_3_Indonesia-India_After_one_week.eaf,2,1,5,661229,697279,36050,695450,697100,1650,REPEAT,NA,NA,NA,TRUE
Colour_game_01_3_Indonesia-India_After_one_week.eaf,2,2,5,661229,697279,36050,661394,662981,1587,BROWN,OS#ISL+NSL,Yes,ISL+NSL,FALSE
Colour_game_01_3_Indonesia-India_After_one_week.eaf,2,2,5,661229,697279,36050,663388,671287,7899,TREE-POST,LW,Yes,,FALSE
Colour_game_01_3_Indonesia-India_After_one_week.eaf,2,2,5,661229,697279,36050,671287,671780,493,SAME,NA,,,FALSE
Colour_game_01_3_Indonesia-India_After_one_week.eaf,2,2,5,661229,697279,36050,671780,672056,276,THERE,IX,,,FALSE
Colour_game_01_3_Indonesia-India_After_one_week.eaf,2,2,5,661229,697279,36050,672056,674123,2067,COLUMN,LW,,,FALSE
Colour_game_01_3_Indonesia-India_After_one_week.eaf,2,2,5,661229,697279,36050,674123,675060,937,BROWN,OS#ISL+NSL,Yes,ISL+NSL,FALSE
Colour_game_01_3_Indonesia-India_After_one_week.eaf,2,2,5,661229,697279,36050,675448,676948,1500,BROWN,OS#ISL+NSL,Yes,ISL+NSL,FALSE
Colour_game_01_3_Indonesia-India_After_one_week.eaf,2,2,5,661229,697279,36050,681156,684306,3150,BROWN,OS#ISL+NSL,Yes,NSL+ISL,FALSE
Colour_game_01_3_Indonesia-India_After_one_week.eaf,2,2,5,661229,697279,36050,684439,684656,217,SAME,NA,,,FALSE
Colour_game_01_3_Indonesia-India_After_one_week.eaf,2,2,5,661229,697279,36050,684656,685338,682,THERE,IX,Yes,,FALSE
Colour_game_01_3_Indonesia-India_After_one_week.eaf,2,2,5,661229,697279,36050,692150,696400,4250,TREE-POST,LW,Yes,,FALSE
Colour_game_01_3_Indonesia-India_After_one_week.eaf,2,1,7,527406,529270,1864,528597,529226,629,BLACK,OS#ISL,NA,NA,TRUE
Colour_game_01_3_Indonesia-India_After_one_week.eaf,2,2,7,527406,529270,1864,527511,528097,586,BLACK,OS#ISL,Yes,ISL,FALSE
Colour_game_01_3_Indonesia-India_After_one_week.eaf,2,2,18,1011898,1014042,2144,1011898,1014042,2144,SAME,NA,,,FALSE
Colour_game_01_3_Indonesia-India_After_one_week.eaf,2,2,19,974899,981201,6302,974907,976657,1750,YELLOW,OS,No,ISL,FALSE
Colour_game_01_3_Indonesia-India_After_one_week.eaf,2,2,19,974899,981201,6302,976657,977615,958,SAME,NA,,,FALSE
Colour_game_01_3_Indonesia-India_After_one_week.eaf,2,2,19,974899,981201,6302,977647,978084,437,IX,NA,,,FALSE
Colour_game_01_3_Indonesia-India_After_one_week.eaf,2,2,19,974899,981201,6302,978105,979417,1312,SUN,NA,Yes,,FALSE
Colour_game_01_3_Indonesia-India_After_one_week.eaf,2,2,19,974899,981201,6302,979417,980105,688,SAME,NA,,,FALSE
Colour_game_01_3_Indonesia-India_After_one_week.eaf,2,2,19,974899,981201,6302,980105,981147,1042,SUN,NA,Yes,,FALSE
Colour_game_01_3_Jordan-Nepal_After_one_week.eaf,1,1,15,788009,790231,2222,788037,789285,1248,GREEN,OS,No,ISL,FALSE
Colour_game_01_3_Jordan-Nepal_After_one_week.eaf,1,1,15,788009,790231,2222,789285,790220,935,DARK,NA,,,FALSE
Colour_game_01_3_Jordan-Nepal_After_one_week.eaf,1,2,1,24650,26546,1896,23244,24588,1344,RED,OS#NSL,Yes,NSL,FALSE
Colour_game_01_3_Jordan-Nepal_After_one_week.eaf,1,1,20,413324,415721,2397,413743,414794,1051,RED,OS,Yes,NSL,FALSE
Colour_game_01_3_Jordan-Nepal_After_one_week.eaf,1,1,18,1038200,1041201,3001,1039848,1041166,1318,SAME,NA,,,FALSE
Colour_game_01_3_Jordan-Nepal_After_one_week.eaf,1,2,18,1038200,1041201,3001,1038974,1040342,1368,YELLOW,OS#NSL,Yes,NSL,FALSE
Colour_game_01_3_Jordan-Nepal_After_one_week.eaf,1,1,19,1021041,1026040,4999,1023463,1026356,2893,SAME,NA,,,FALSE
Colour_game_01_3_Jordan-Nepal_After_one_week.eaf,1,1,24,549932,552132,2200,549932,552132,2200,FLOWER,LW,,,FALSE
Colour_game_01_3_Jordan-Nepal_After_one_week.eaf,1,2,24,549932,552132,2200,550666,554965,4299,FLOWER,LW,,,FALSE
Colour_game_01_3_Jordan-Nepal_After_one_week.eaf,1,1,16,585305,587972,2667,586753,587931,1178,WALL,IX,,,FALSE
Colour_game_01_3_Jordan-Nepal_After_one_week.eaf,1,1,3,813282,817982,4700,813357,815214,1857,RED,OS,Yes,JSL,FALSE
Colour_game_01_3_Jordan-Nepal_After_one_week.eaf,1,1,3,813282,817982,4700,815214,816771,1557,RED,OS,Yes,NSL,FALSE
Colour_game_01_3_Jordan-Nepal_After_one_week.eaf,1,2,3,813282,817982,4700,816767,817953,1186,RED,OS,NA,NA,TRUE
Colour_game_01_3_Jordan-Nepal_After_one_week.eaf,1,1,14,183652,187497,3845,183687,185554,1867,GREEN,OS#ISL,No,ISL,FALSE
Colour_game_01_3_Jordan-Nepal_After_one_week.eaf,1,1,14,183652,187497,3845,186503,187385,882,GREEN,OS#NSL,No,NSL,FALSE
Colour_game_01_3_Jordan-Nepal_After_one_week.eaf,1,2,14,183652,187497,3845,185464,186809,1345,GREEN,OS#NSL,NA,NA,TRUE
Colour_game_01_3_Jordan-Nepal_After_one_week.eaf,2,2,16,588286,591997,3711,588264,591936,3672,SAME,NA,,,FALSE
Colour_game_01_3_Jordan-Nepal_After_one_week.eaf,2,2,19,1008678,1014678,6000,1008707,1009207,500,SAME,NA,,,FALSE
Colour_game_01_3_Jordan-Nepal_After_one_week.eaf,2,2,19,1008678,1014678,6000,1009207,1014570,5363,BLIND ROAD,LW,Yes,,FALSE
Colour_game_01_3_Jordan-Nepal_After_one_week.eaf,2,1,18,1038977,1040322,1345,1039848,1041166,1318,SAME,NA,,,FALSE
Colour_game_01_3_Jordan-Nepal_After_one_week.eaf,2,2,18,1038977,1040322,1345,1038974,1040342,1368,YELLOW,OS#NSL,Yes,NSL,FALSE
Colour_game_01_3_Jordan-Nepal_After_one_week.eaf,2,1,24,550666,554965,4299,549932,552132,2200,FLOWER,LW,,,FALSE
Colour_game_01_3_Jordan-Nepal_After_one_week.eaf,2,2,24,550666,554965,4299,550666,554965,4299,FLOWER,LW,,,FALSE
Colour_game_01_3_Jordan-Nepal_After_one_week.eaf,2,1,5,386124,399578,13454,397410,398110,700,WATCH,IX,NA,NA,TRUE
Colour_game_01_3_Jordan-Nepal_After_one_week.eaf,2,2,5,386124,399578,13454,386124,387921,1797,BROWN,OS#ISL+NSL,Yes,ISL+NSL,FALSE
Colour_game_01_3_Jordan-Nepal_After_one_week.eaf,2,2,5,386124,399578,13454,388455,394733,6278,DOOR-YESTERDAY-the DOOR,SE,Yes,,FALSE
Colour_game_01_3_Jordan-Nepal_After_one_week.eaf,2,2,5,386124,399578,13454,394733,394922,189,DOOR,IX,,,FALSE
Colour_game_01_3_Jordan-Nepal_After_one_week.eaf,2,2,5,386124,399578,13454,394922,395764,842,SAME,NA,,,FALSE
Colour_game_01_3_Jordan-Nepal_After_one_week.eaf,2,2,1,23234,24896,1662,23244,24588,1344,RED,OS#NSL,Yes,NSL,FALSE
Colour_game_01_3_Jordan-Nepal_After_one_week.eaf,2,2,7,527256,529099,1843,527256,529099,1843,BLACK,OS#NSL,Yes,NSL,FALSE
Colour_game_04_1_Indonesia-India_After_three_week.eaf,1,1,19,630614,635947,5333,630700,633600,2900,LEMON,LW,Yes,,FALSE
Colour_game_04_1_Indonesia-India_After_three_week.eaf,1,1,19,630614,635947,5333,633900,635800,1900,PEEL,LW,Yes,,FALSE
Colour_game_04_1_Indonesia-India_After_three_week.eaf,1,1,9,79509,87500,7991,83560,84746,1186,WHITE,NA,,,FALSE
Colour_game_04_1_Indonesia-India_After_three_week.eaf,1,1,9,79509,87500,7991,84863,85672,809,BLACK,NA,,,FALSE
Colour_game_04_1_Indonesia-India_After_three_week.eaf,1,1,9,79509,87500,7991,85672,85947,275,BLACK,NA,,,FALSE
Colour_game_04_1_Indonesia-India_After_three_week.eaf,1,1,9,79509,87500,7991,85947,86587,640,WHITE,NA,,,FALSE
Colour_game_04_1_Indonesia-India_After_three_week.eaf,1,1,9,79509,87500,7991,86587,87560,973,MIX,NA,,,FALSE
Colour_game_04_1_Indonesia-India_After_three_week.eaf,1,1,12,186952,193848,6896,189514,190175,661,,NA,,,FALSE
Colour_game_04_1_Indonesia-India_After_three_week.eaf,1,1,12,186952,193848,6896,190175,190372,197,,NA,,,FALSE
Colour_game_04_1_Indonesia-India_After_three_week.eaf,1,1,12,186952,193848,6896,190372,191272,900,,NA,,,FALSE
Colour_game_04_1_Indonesia-India_After_three_week.eaf,1,2,12,186952,193848,6896,191452,191715,263,,NA,,,FALSE
Colour_game_04_1_Indonesia-India_After_three_week.eaf,1,2,12,186952,193848,6896,191771,192892,1121,,NA,,,FALSE
Colour_game_04_1_Indonesia-India_After_three_week.eaf,1,1,16,457568,462309,4741,457675,459434,1759,GREEN,OS,No,ISL,FALSE
Colour_game_04_1_Indonesia-India_After_three_week.eaf,1,1,16,457568,462309,4741,459434,459967,533,CORRECT,NA,,,FALSE
Colour_game_04_1_Indonesia-India_After_three_week.eaf,1,1,16,457568,462309,4741,459967,460483,516,GREEN1-1,NA,,,FALSE
Colour_game_04_1_Indonesia-India_After_three_week.eaf,1,1,16,457568,462309,4741,460483,461008,525,BRIGHT,NA,,,FALSE
Colour_game_04_1_Indonesia-India_After_three_week.eaf,1,1,16,457568,462309,4741,461048,462324,1276,4번째중 1번째,NA,,,FALSE
Colour_game_04_1_Indonesia-India_After_three_week.eaf,1,1,1,7650,9550,1900,7749,9500,1751,RED,OS#INSL+JSL,Yes,INSL+JSL,FALSE
Colour_game_04_1_Indonesia-India_After_three_week.eaf,1,1,20,306435,320955,14520,311420,312120,700,RED,OS,Yes,JSL,FALSE
Colour_game_04_1_Indonesia-India_After_three_week.eaf,1,1,18,713362,721328,7966,716028,716957,929,YELLOW,OS#ISL,No,ISL,FALSE
Colour_game_04_1_Indonesia-India_After_three_week.eaf,1,1,18,713362,721328,7966,718137,719253,1116,YELLOW,OS#ISL,No,ISL,FALSE
Colour_game_04_1_Indonesia-India_After_three_week.eaf,1,1,14,31602,33757,2155,31622,33688,2066,GREEN,OS#ISL,No,ISL,FALSE
Colour_game_04_1_Indonesia-India_After_three_week.eaf,1,1,24,473921,479337,5416,473971,476204,2233,FLOWER,LW,,,FALSE
Colour_game_04_1_Indonesia-India_After_three_week.eaf,1,1,24,473921,479337,5416,478389,478861,472,TONGUE,IX,Yes,,FALSE
Colour_game_04_1_Indonesia-India_After_three_week.eaf,1,1,15,727651,740533,12882,730880,731527,647,GREEN1-1,NA,,,FALSE
Colour_game_04_1_Indonesia-India_After_three_week.eaf,1,1,15,727651,740533,12882,731527,731776,249,첫번째,IX,,,FALSE
Colour_game_04_1_Indonesia-India_After_three_week.eaf,1,1,15,727651,740533,12882,731776,732419,643,BRIGHT,NA,,,FALSE
Colour_game_04_1_Indonesia-India_After_three_week.eaf,1,1,15,727651,740533,12882,732419,739339,6920,4번째중 3번째,NA,,,FALSE
Colour_game_04_1_Indonesia-India_After_three_week.eaf,1,1,3,555289,587819,32530,559629,560279,650,RED,OS,Yes,JSL,FALSE
Colour_game_04_1_Indonesia-India_After_three_week.eaf,2,1,9,87394,90554,3160,86587,87560,973,MIX,NA,,,FALSE
Colour_game_04_1_Indonesia-India_After_three_week.eaf,2,2,18,722474,724540,2066,723349,724182,833,SAME,NA,,,FALSE
Colour_game_04_1_Indonesia-India_After_three_week.eaf,2,2,1,14769,18584,3815,17195,17620,425,RED,OS#INSL+JSL,Yes,INSL+JSL,FALSE
Colour_game_04_1_Indonesia-India_After_three_week.eaf,2,2,19,647982,650610,2628,647982,650610,2628,SAME,NA,,,FALSE
Colour_game_04_1_Indonesia-India_After_three_week.eaf,2,2,5,443047,449813,6766,444181,445956,1775,BROWN,OS#ISL+NSL,Yes,ISL+NSL,FALSE
Colour_game_04_1_Indonesia-India_After_three_week.eaf,2,2,7,409890,418656,8766,409950,411065,1115,BLACK,OS#ISL,Yes,ISL,FALSE
Colour_game_04_1_Jordan-Nepal_After_three_weeks.eaf,1,1,15,902044,911902,9858,903587,904595,1008,GREEN,OS,No,ISL,FALSE
Colour_game_04_1_Jordan-Nepal_After_three_weeks.eaf,1,1,15,902044,911902,9858,904595,905228,633,첫째,NA,,,FALSE
Colour_game_04_1_Jordan-Nepal_After_three_weeks.eaf,1,1,15,902044,911902,9858,905228,907250,2022,WALL,IX,Yes,,FALSE
Colour_game_04_1_Jordan-Nepal_After_three_weeks.eaf,1,1,15,902044,911902,9858,907250,908510,1260,둘째,NA,,,FALSE
Colour_game_04_1_Jordan-Nepal_After_three_weeks.eaf,1,1,15,902044,911902,9858,908510,909200,690,GREEN,OS,No,,FALSE
Colour_game_04_1_Jordan-Nepal_After_three_weeks.eaf,1,1,15,902044,911902,9858,909200,909500,300,3,NA,,,FALSE
Colour_game_04_1_Jordan-Nepal_After_three_weeks.eaf,1,1,15,902044,911902,9858,909500,910500,1000,DARK,NA,,,FALSE
Colour_game_04_1_Jordan-Nepal_After_three_weeks.eaf,1,1,18,641642,645125,3483,641658,643250,1592,SAME,NA,,,FALSE
Colour_game_04_1_Jordan-Nepal_After_three_weeks.eaf,1,1,18,641642,645125,3483,643250,643793,543,YELLOW,OS,No,ISL,FALSE
Colour_game_04_1_Jordan-Nepal_After_three_weeks.eaf,1,1,18,641642,645125,3483,643793,645115,1322,SUN,NA,Yes,,FALSE
Colour_game_04_1_Jordan-Nepal_After_three_weeks.eaf,1,1,3,542678,550498,7820,547697,548709,1012,RED,OS,Yes,NSL,FALSE
Colour_game_04_1_Jordan-Nepal_After_three_weeks.eaf,1,1,24,395177,396602,1425,395224,396558,1334,FLOWER,LW,,,FALSE
Colour_game_04_1_Jordan-Nepal_After_three_weeks.eaf,1,1,16,292213,294838,2625,293706,294636,930,WALL,IX,,,FALSE
Colour_game_04_1_Jordan-Nepal_After_three_weeks.eaf,1,1,9,50072,54172,4100,51024,51974,950,SAME,NA,,,FALSE
Colour_game_04_1_Jordan-Nepal_After_three_weeks.eaf,1,1,9,50072,54172,4100,52054,53401,1347,TABLE,IX,,,FALSE
Colour_game_04_1_Jordan-Nepal_After_three_weeks.eaf,1,2,6,296638,299731,3093,295859,296686,827,SAME,NA,,,FALSE
Colour_game_04_1_Jordan-Nepal_After_three_weeks.eaf,1,1,14,77123,79335,2212,77141,79328,2187,GREEN,OS#ISL,No,ISL,FALSE
Colour_game_04_1_Jordan-Nepal_After_three_weeks.eaf,1,1,14,77123,79335,2212,79328,80274,946,CORRECT,NA,,,FALSE
Colour_game_04_1_Jordan-Nepal_After_three_weeks.eaf,1,1,19,821537,826342,4805,821905,825284,3379,SAME,NA,,,FALSE
Colour_game_04_1_Jordan-Nepal_After_three_weeks.eaf,1,1,20,415885,417275,1390,415885,417275,1390,RED,OS,Yes,NSL,FALSE
Colour_game_04_1_Jordan-Nepal_After_three_weeks.eaf,2,2,18,622190,627254,5064,622331,622899,568,YELLOW,OS#ISL,No,ISL,FALSE
Colour_game_04_1_Jordan-Nepal_After_three_weeks.eaf,2,2,18,622190,627254,5064,623935,626201,2266,BEFORE-ROAD,SE,Yes,,FALSE
Colour_game_04_1_Jordan-Nepal_After_three_weeks.eaf,2,2,18,622190,627254,5064,626201,627159,958,UNDERSTAND,NA,,,FALSE
Colour_game_04_1_Jordan-Nepal_After_three_weeks.eaf,2,2,19,802621,816837,14216,802907,803338,431,YELLOW,OS,No,ISL,FALSE
Colour_game_04_1_Jordan-Nepal_After_three_weeks.eaf,2,2,19,802621,816837,14216,803338,808671,5333,BOFORE ROAD,SE,,,FALSE
Colour_game_04_1_Jordan-Nepal_After_three_weeks.eaf,2,2,19,802621,816837,14216,808941,812194,3253,맹인이 걷는 그 길,LW,Yes,,FALSE
Colour_game_04_1_Jordan-Nepal_After_three_weeks.eaf,2,2,19,802621,816837,14216,813860,814481,621,BRIGHT,NA,,,FALSE
Colour_game_04_1_Jordan-Nepal_After_three_weeks.eaf,2,2,19,802621,816837,14216,814481,816619,2138,DARK,NA,,,FALSE
Colour_game_04_1_Jordan-Nepal_After_three_weeks.eaf,2,2,7,382072,383635,1563,382094,383605,1511,BLACK,OS#NSL,Yes,NSL,FALSE
Colour_game_04_1_Jordan-Nepal_After_three_weeks.eaf,2,2,9,58193,60849,2656,58993,59849,856,SAME,NA,,,FALSE
Colour_game_04_1_Jordan-Nepal_After_three_weeks.eaf,2,2,8,463192,466569,3377,463192,466569,3377,1-1의 그림에서 옷의 색깔. 쥐색,NA,,,FALSE
Colour_game_04_1_Jordan-Nepal_After_three_weeks.eaf,2,2,16,295157,296638,1481,295859,296686,827,SAME,NA,,,FALSE
Colour_game_04_1_Jordan-Nepal_After_three_weeks.eaf,2,2,1,12449,15276,2827,12426,15311,2885,RED,OS#INSL+JSL,Yes,INSL+JSL,FALSE
Colour_game_04_1_Jordan-Nepal_After_three_weeks.eaf,2,2,5,302940,308140,5200,304700,306894,2194,BROWN,OS#ISL+NSL,Yes,ISL+NSL,FALSE
Colour_game_04_2_Jordan-Indonesia_After_three_week.eaf,1,1,20,106133,109316,3183,106233,109283,3050,RED,OS,Yes,JSL,FALSE
Colour_game_04_2_Jordan-Indonesia_After_three_week.eaf,1,1,14,627906,632268,4362,629877,632106,2229,GREEN,OS#ISL,No,ISL,FALSE
Colour_game_04_2_Jordan-Indonesia_After_three_week.eaf,1,2,14,627906,632268,4362,631215,631882,667,GREEN,OS#ISL,NA,NA,TRUE
Colour_game_04_2_Jordan-Indonesia_After_three_week.eaf,1,1,3,388255,388905,650,388222,388889,667,RED,OS,Yes,JSL,FALSE
Colour_game_04_2_Jordan-Indonesia_After_three_week.eaf,1,1,5,596499,600414,3915,597151,600432,3281,WATCH,IX,,,FALSE
Colour_game_04_2_Jordan-Indonesia_After_three_week.eaf,1,1,19,44749,49749,5000,44844,48930,4086,YELLOW,OS,No,JSL,FALSE
Colour_game_04_2_Jordan-Indonesia_After_three_week.eaf,1,1,7,138138,143396,5258,141735,141835,100,2형에서,본인수정,,,FALSE
Colour_game_04_2_Jordan-Indonesia_After_three_week.eaf,1,1,7,138138,143396,5258,141835,143251,1416,BLACK,OS#ISL,Yes,ISL,FALSE
Colour_game_04_2_Jordan-Indonesia_After_three_week.eaf,1,2,7,138138,143396,5258,140408,142580,2172,BLACK,OS#ISL,Yes,ISL,FALSE
Colour_game_04_2_Jordan-Indonesia_After_three_week.eaf,1,1,1   빨강,653714,657881,4167,653762,654288,526,RED,OS#NSL,Yes,NSL,FALSE
Colour_game_04_2_Jordan-Indonesia_After_three_week.eaf,1,1,1   빨강,653714,657881,4167,654696,655801,1105,RED,OS#INSL+JSL,Yes,INSL+JSL,FALSE
Colour_game_04_2_Jordan-Indonesia_After_three_week.eaf,1,1,16,169149,171299,2150,169166,171308,2142,WALL,IX,,,FALSE
Colour_game_04_2_Jordan-Indonesia_After_three_week.eaf,2,1,15,616695,623907,7212,619494,620129,635,LOW,NA,NA,NA,TRUE
Colour_game_04_2_Jordan-Indonesia_After_three_week.eaf,2,1,15,616695,623907,7212,620129,620913,784,BOOGER,LW,NA,NA,TRUE
Colour_game_04_2_Jordan-Indonesia_After_three_week.eaf,2,1,15,616695,623907,7212,620913,621821,908,LOW,NA,NA,NA,TRUE
Colour_game_04_2_Jordan-Indonesia_After_three_week.eaf,2,2,15,616695,623907,7212,616671,618186,1515,GREEN,OS,No,JSL,FALSE
Colour_game_04_2_Jordan-Indonesia_After_three_week.eaf,2,2,15,616695,623907,7212,618186,619603,1417,LOW,NA,,,FALSE
Colour_game_04_2_Jordan-Indonesia_After_three_week.eaf,2,2,15,616695,623907,7212,621355,622046,691,LOW,NA,,,FALSE
Colour_game_04_2_Jordan-Indonesia_After_three_week.eaf,2,2,14,640306,643072,2766,642325,642626,301,GREEN,OS#ISL,No,ISL,FALSE
Colour_game_04_2_Jordan-Indonesia_After_three_week.eaf,2,2,3,380636,383203,2567,380722,382972,2250,RED,OS,Yes,JSL,FALSE
Colour_game_04_2_Jordan-Indonesia_After_three_week.eaf,2,1,7,138138,143396,5258,141735,141835,100,2형에서,본인수정,,,FALSE
Colour_game_04_2_Jordan-Indonesia_After_three_week.eaf,2,1,7,138138,143396,5258,141835,143251,1416,BLACK,OS#ISL,Yes,ISL,FALSE
Colour_game_04_2_Jordan-Indonesia_After_three_week.eaf,2,2,7,138138,143396,5258,140408,142580,2172,BLACK,OS#ISL,Yes,ISL,FALSE
Colour_game_04_2_Jordan-Indonesia_After_three_week.eaf,2,2,24,29171,31105,1934,29171,31105,1934,FLOWER,LW,,,FALSE
Colour_game_04_2_Jordan-Indonesia_After_three_week.eaf,2,2,18,283466,284982,1516,283542,284239,697,YELLOW,OS#JSL,,JSL,FALSE
Colour_game_04_2_Jordan-Indonesia_After_three_week.eaf,2,2,18,283466,284982,1516,284239,284634,395,GOOD,NA,,,FALSE
Colour_game_04_2_Jordan-Indonesia_After_three_week.eaf,2,2,18,283466,284982,1516,284634,284942,308,CORRECT,NA,,,FALSE
Colour_game_04_2_Nepal-India_After_three_weeks.eaf,1,1,19,74111,82738,8627,74658,75852,1194,BLIND,LW,,,FALSE
Colour_game_04_2_Nepal-India_After_three_weeks.eaf,1,1,19,74111,82738,8627,75971,76344,373,THERE,NA,,,FALSE
Colour_game_04_2_Nepal-India_After_three_weeks.eaf,1,1,19,74111,82738,8627,76359,78636,2277,ROAD,LW,,,FALSE
Colour_game_04_2_Nepal-India_After_three_weeks.eaf,1,1,19,74111,82738,8627,78636,80546,1910,BLIND,LW,,,FALSE
Colour_game_04_2_Nepal-India_After_three_weeks.eaf,1,1,19,74111,82738,8627,80572,81692,1120,ROAD,LW,,,FALSE
Colour_game_04_2_Nepal-India_After_three_weeks.eaf,1,1,19,74111,82738,8627,81715,82655,940,SAME,NA,,,FALSE
Colour_game_04_2_Nepal-India_After_three_weeks.eaf,1,2,14,650766,653440,2674,650546,651723,1177,2번째,NA,,,FALSE
Colour_game_04_2_Nepal-India_After_three_weeks.eaf,1,1,5,637976,641336,3360,638880,640598,1718, 손등,IX ,,,FALSE
Colour_game_04_2_Nepal-India_After_three_weeks.eaf,1,1,20,163895,168495,4600,164025,165807,1782,RED,OS,Yes,NSL,FALSE
Colour_game_04_2_Nepal-India_After_three_weeks.eaf,1,1,16,7116,8821,1705,7098,7548,450,GREEN,OS,No,ISL,FALSE
Colour_game_04_2_Nepal-India_After_three_weeks.eaf,1,1,16,7116,8821,1705,7548,7886,338,BRIGHT,NA,,,FALSE
Colour_game_04_2_Nepal-India_After_three_weeks.eaf,1,1,16,7116,8821,1705,7886,8136,250,WALL,IX,Yes,,FALSE
Colour_game_04_2_Nepal-India_After_three_weeks.eaf,1,1,16,7116,8821,1705,8143,8571,428,SAME,NA,,,FALSE
Colour_game_04_2_Nepal-India_After_three_weeks.eaf,1,1,16,7116,8821,1705,8571,8800,229,WALL,IX,Yes,,FALSE
Colour_game_04_2_Nepal-India_After_three_weeks.eaf,1,1,7,32428,34499,2071,32416,34408,1992,BLACK,OS#NSL,Yes,NSL,FALSE
Colour_game_04_2_Nepal-India_After_three_weeks.eaf,1,1,1,670981,672513,1532,670993,672390,1397,RED,OS,Yes,JSL,FALSE
Colour_game_04_2_Nepal-India_After_three_weeks.eaf,2,2,15,625813,633373,7560,625821,626695,874,GREEN,OS,No,ISL,FALSE
Colour_game_04_2_Nepal-India_After_three_weeks.eaf,2,2,15,625813,633373,7560,626701,633372,6671,1234,NA,,,FALSE
Colour_game_04_2_Nepal-India_After_three_weeks.eaf,2,2,7,48173,51800,3627,48738,49789,1051,BLACK,OS#ISL,Yes,ISL,FALSE
Colour_game_04_2_Nepal-India_After_three_weeks.eaf,2,2,7,48173,51800,3627,47858,48264,406,black1-3수형으로 BLACK1-4수동,NA,NA,NA,TRUE
Colour_game_04_2_Nepal-India_After_three_weeks.eaf,2,2,7,48173,51800,3627,48738,49789,1051,black1-3수형으로 BLACK1-4수동,NA,NA,NA,TRUE
Colour_game_04_2_Nepal-India_After_three_weeks.eaf,2,2,3,495714,497928,2214,495749,496464,715,RED,OS,Yes,JSL,FALSE
Colour_game_04_2_Nepal-India_After_three_weeks.eaf,2,2,3,495714,497928,2214,496571,497356,785,RED,OS,Yes,NSL,FALSE
Colour_game_04_2_Nepal-India_After_three_weeks.eaf,2,2,3,495714,497928,2214,497356,497713,357,RED,OS,Yes,JSL,FALSE
Colour_game_04_2_Nepal-India_After_three_weeks.eaf,2,2,14,649540,649995,455,649534,649988,454,GREEN,OS#ISL,No,ISL,FALSE
Colour_game_04_2_Nepal-India_After_three_weeks.eaf,2,2,14,649540,649995,455,649988,650546,558,CORRECT,NA,,,FALSE
Colour_game_04_2_Nepal-India_After_three_weeks.eaf,2,2,18,313440,319471,6031,313470,316627,3157,YELLOW,OS#ISL,No,ISL,FALSE
Colour_game_04_2_Nepal-India_After_three_weeks.eaf,2,2,18,313440,319471,6031,316627,316755,128,YOU,IX,,,FALSE
Colour_game_04_2_Nepal-India_After_three_weeks.eaf,2,2,18,313440,319471,6031,316764,317004,240,NOSE-PENDANT,IX,Yes,,FALSE
Colour_game_04_2_Nepal-India_After_three_weeks.eaf,2,2,18,313440,319471,6031,317016,317100,84,SAME,NA,,,FALSE
Colour_game_04_2_Nepal-India_After_three_weeks.eaf,2,2,18,313440,319471,6031,317108,317298,190,YOU,NA,,,FALSE
Colour_game_04_2_Nepal-India_After_three_weeks.eaf,2,2,18,313440,319471,6031,317301,317931,630,NOSE-PENDANT,IX,Yes,,FALSE
Colour_game_04_2_Nepal-India_After_three_weeks.eaf,2,2,18,313440,319471,6031,317956,318181,225,THAT,IX,,,FALSE
Colour_game_04_2_Nepal-India_After_three_weeks.eaf,2,2,18,313440,319471,6031,318181,318469,288,SIGN,NA,,,FALSE
Colour_game_04_2_Nepal-India_After_three_weeks.eaf,2,2,18,313440,319471,6031,318469,319406,937,YELLOW,OS#ISL,No,ISL,FALSE
Colour_game_04_2_Nepal-India_After_three_weeks.eaf,2,2,24,68265,69368,1103,68265,69368,1103,FLOWER,LW,,,FALSE
Colour_game_04_3_Jordan-India_After_three_weeks.eaf,1,1,12,123818,143059,19241,136139,137389,1250,WATER,NA,,,FALSE
Colour_game_04_3_Jordan-India_After_three_weeks.eaf,1,1,12,123818,143059,19241,137389,140745,3356,SEA,NA,,,FALSE
Colour_game_04_3_Jordan-India_After_three_weeks.eaf,1,1,12,123818,143059,19241,140755,141403,648,SAME,NA,,,FALSE
Colour_game_04_3_Jordan-India_After_three_weeks.eaf,1,1,12,123818,143059,19241,141420,142657,1237,DARK,NA,,,FALSE
Colour_game_04_3_Jordan-India_After_three_weeks.eaf,1,1,5 밤,407615,409063,1448,407622,408222,600,BROWN,OS#ISL+NSL,Yes,ISL+NSL,FALSE
Colour_game_04_3_Jordan-India_After_three_weeks.eaf,1,2,5 밤,407615,409063,1448,407975,409273,1298, WATCH,IX,,,FALSE
Colour_game_04_3_Jordan-India_After_three_weeks.eaf,1,1,14,419029,422445,3416,419019,419540,521,GREEN,OS#ISL,No,ISL,FALSE
Colour_game_04_3_Jordan-India_After_three_weeks.eaf,1,1,14,419029,422445,3416,419637,420512,875,CORRECT,NA,,,FALSE
Colour_game_04_3_Jordan-India_After_three_weeks.eaf,1,1,14,419029,422445,3416,420512,421620,1108,GREEN,OS#ISL,No,ISL,FALSE
Colour_game_04_3_Jordan-India_After_three_weeks.eaf,1,1,14,419029,422445,3416,421620,422424,804,CORRECT,NA,,,FALSE
Colour_game_04_3_Jordan-India_After_three_weeks.eaf,1,1,19,277567,280480,2913,279744,280449,705,YELLOW,OS,,JSL,FALSE
Colour_game_04_3_Jordan-India_After_three_weeks.eaf,1,1,19,277567,280480,2913,280481,281149,668,DARK,NA,,,FALSE
Colour_game_04_3_Jordan-India_After_three_weeks.eaf,1,1,1,192490,193750,1260,192416,193716,1300,RED,OS#INSL+JSL,Yes,INSL+JSL,FALSE
Colour_game_04_3_Jordan-India_After_three_weeks.eaf,1,1,21,181454,184453,2999,181471,184403,2932,SAME,NA,,,FALSE
Colour_game_04_3_Jordan-India_After_three_weeks.eaf,1,1,16,710035,713090,3055,711856,712393,537,WALL,IX,,,FALSE
Colour_game_04_3_Jordan-India_After_three_weeks.eaf,1,1,18,248801,263976,15175,248863,253652,4789,carriageway,LW#자동차도로,,,FALSE
Colour_game_04_3_Jordan-India_After_three_weeks.eaf,1,1,18,248801,263976,15175,253652,254727,1075,BLACK,OS#JSL,Yes,JSL,FALSE
Colour_game_04_3_Jordan-India_After_three_weeks.eaf,1,1,18,248801,263976,15175,255007,255662,655,YELLOW,OS#JSL,No,JSL,FALSE
Colour_game_04_3_Jordan-India_After_three_weeks.eaf,1,1,18,248801,263976,15175,255947,256512,565,BLACK,OS#JSL,Yes,JSL,FALSE
Colour_game_04_3_Jordan-India_After_three_weeks.eaf,1,1,18,248801,263976,15175,256669,257299,630,YELLOW,OS#JSL,No,JSL,FALSE
Colour_game_04_3_Jordan-India_After_three_weeks.eaf,1,1,18,248801,263976,15175,257414,258149,735,THAT!,IX,,,FALSE
Colour_game_04_3_Jordan-India_After_three_weeks.eaf,1,1,18,248801,263976,15175,260261,261575,1314,SUN,NA,Yes,,FALSE
Colour_game_04_3_Jordan-India_After_three_weeks.eaf,1,1,18,248801,263976,15175,261575,262862,1287,SUN,NA,Yes,,FALSE
Colour_game_04_3_Jordan-India_After_three_weeks.eaf,1,1,18,248801,263976,15175,262862,263262,400,SUN,NA,Yes,,FALSE
Colour_game_04_3_Jordan-India_After_three_weeks.eaf,1,1,18,248801,263976,15175,263262,263962,700,SAME,NA,,,FALSE
Colour_game_04_3_Jordan-India_After_three_weeks.eaf,1,2,18,248801,263976,15175,258254,259500,1246,YELLOW,OS#JSL,NA,NA,TRUE
Colour_game_04_3_Jordan-India_After_three_weeks.eaf,1,1,19,270649,271364,715,270679,271235,556,YELLOW,OS,No,JSL,FALSE
Colour_game_04_3_Jordan-India_After_three_weeks.eaf,1,1,19,270649,271364,715,271395,272179,784,DARK,NA,,,FALSE
Colour_game_04_3_Jordan-India_After_three_weeks.eaf,1,2,19,270649,271364,715,268775,271392,2617,BLACK,OS#ISL,Yes,ISL,FALSE
Colour_game_04_3_Jordan-India_After_three_weeks.eaf,1,1,3,636404,642193,5789,640245,641842,1597,RED,OS,Yes,NSL,FALSE
Colour_game_04_3_Jordan-India_After_three_weeks.eaf,2,1,7,268764,270662,1898,270679,271235,556,YELLOW,OS,No,JSL,FALSE
Colour_game_04_3_Jordan-India_After_three_weeks.eaf,2,2,7,268764,270662,1898,268775,271392,2617,BLACK,OS#ISL,Yes,ISL,FALSE
Colour_game_04_3_Jordan-India_After_three_weeks.eaf,2,2,1  빨강,204668,206223,1555,204688,205125,437,RED,OS#INSL+JSL,Yes,INSL+JSL,FALSE
Colour_game_04_3_Jordan-India_After_three_weeks.eaf,2,2,1  빨강,204668,206223,1555,205205,206195,990,RED,OS#NSL,Yes,NSL,FALSE
Colour_game_04_3_Jordan-India_After_three_weeks.eaf,2,2,24  분홍,494009,497580,3571,494009,497580,3571,FLOWER,LW,,,FALSE
Colour_game_04_3_Jordan-India_After_three_weeks.eaf,2,2,7,308945,309945,1000,308960,309841,881,BLACK,OS#ISL,Yes,ISL,FALSE
Colour_game_04_3_Jordan-India_After_three_weeks.eaf,2,2,12,3813,7813,4000,6354,6473,119,?,NA,,,FALSE
Colour_game_04_3_Jordan-India_After_three_weeks.eaf,2,2,12,3813,7813,4000,6633,7052,419,SKY?,NA,,,FALSE
Colour_game_04_3_Jordan-India_After_three_weeks.eaf,2,2,12,3813,7813,4000,7180,7602,422,SAME,NA,,,FALSE
Colour_game_04_3_Jordan-India_After_three_weeks.eaf,2,2,21,155916,170338,14422,160952,162237,1285,ORANGE?,NA,,,FALSE
Colour_game_04_3_Jordan-India_After_three_weeks.eaf,2,2,21,155916,170338,14422,162394,163965,1571,PEEL,NA,,,FALSE
Colour_game_04_3_Jordan-India_After_three_weeks.eaf,2,2,21,155916,170338,14422,164086,164429,343,ORANGE?,NA,,,FALSE
Colour_game_04_3_Jordan-India_After_three_weeks.eaf,2,2,21,155916,170338,14422,165047,165602,555,BRIGHT,NA,,,FALSE
Colour_game_04_3_Jordan-India_After_three_weeks.eaf,2,2,21,155916,170338,14422,166042,166992,950,DARK,NA,,,FALSE
Colour_game_04_3_Jordan-India_After_three_weeks.eaf,2,2,21,155916,170338,14422,167562,168037,475,BRIGHT,NA,,,FALSE
Colour_game_04_3_Jordan-India_After_three_weeks.eaf,2,2,21,155916,170338,14422,168277,169123,846,DARK,NA,,,FALSE
Colour_game_04_3_Jordan-India_After_three_weeks.eaf,2,1,15,37135,53810,16675,37783,39756,1973,REPEAT,NA,NA,NA,TRUE
Colour_game_04_3_Jordan-India_After_three_weeks.eaf,2,2,15,37135,53810,16675,37180,41260,4080,GREEN,OS,No,ISL,FALSE
Colour_game_04_3_Jordan-India_After_three_weeks.eaf,2,2,15,37135,53810,16675,41929,42146,217,1,NA,,,FALSE
Colour_game_04_3_Jordan-India_After_three_weeks.eaf,2,2,15,37135,53810,16675,42301,42471,170,GREEN,OS,No,ISL,FALSE
Colour_game_04_3_Jordan-India_After_three_weeks.eaf,2,2,15,37135,53810,16675,42557,43410,853,GREEN,OS,No,ISL,FALSE
Colour_game_04_3_Jordan-India_After_three_weeks.eaf,2,2,15,37135,53810,16675,43488,43860,372,2,NA,,,FALSE
Colour_game_04_3_Jordan-India_After_three_weeks.eaf,2,2,15,37135,53810,16675,44107,44297,190,GREEN,OS,,ISL,FALSE
Colour_game_04_3_Jordan-India_After_three_weeks.eaf,2,2,15,37135,53810,16675,44477,44996,519,CORRECT(정확히),NA,,,FALSE
Colour_game_04_3_Jordan-India_After_three_weeks.eaf,2,2,15,37135,53810,16675,45083,45314,231,3,NA,,,FALSE
Colour_game_04_3_Jordan-India_After_three_weeks.eaf,2,2,15,37135,53810,16675,45438,45784,346,FEW-DARK,NA,,,FALSE
Colour_game_04_3_Jordan-India_After_three_weeks.eaf,2,2,15,37135,53810,16675,45927,46169,242,4,NA,,,FALSE
Colour_game_04_3_Jordan-India_After_three_weeks.eaf,2,2,15,37135,53810,16675,46286,47165,879,MANY-DARK,NA,,,FALSE
Colour_game_04_3_Jordan-India_After_three_weeks.eaf,2,2,15,37135,53810,16675,47318,51750,4432,3,NA,,,FALSE
Colour_game_04_3_Jordan-India_After_three_weeks.eaf,2,2,15,37135,53810,16675,51958,52186,228,DARK,NA,,,FALSE
Colour_game_04_3_Jordan-India_After_three_weeks.eaf,2,2,15,37135,53810,16675,52348,53767,1419,3,NA,,,FALSE
Colour_game_04_3_Jordan-India_After_three_weeks.eaf,2,2,20,436985,440985,4000,437108,438389,1281,RED,OS,Yes,JSL,FALSE
Colour_game_04_3_Jordan-India_After_three_weeks.eaf,2,2,20,436985,440985,4000,440151,440467,316,RED,OS,Yes,JSL,FALSE
Colour_game_04_3_Jordan-India_After_three_weeks.eaf,2,1,5,405945,409980,4035,407622,408222,600,BROWN,OS#ISL+NSL,Yes,ISL+NSL,FALSE
Colour_game_04_3_Jordan-India_After_three_weeks.eaf,2,2,5,405945,409980,4035,407975,409273,1298, WATCH,IX,,,FALSE
Colour_game_04_3_Nepal-Indonesia_After_three_weeks.eaf,1,1,5,380834,381814,980,380820,381800,980,SAME,NA,,,FALSE
Colour_game_04_3_Nepal-Indonesia_After_three_weeks.eaf,1,2,5,380834,381814,980,379677,380973,1296,BROWN,OS#ISL+NSL,,,FALSE
Colour_game_04_3_Nepal-Indonesia_After_three_weeks.eaf,1,1,3,609550,613905,4355,609579,613887,4308,RED,OS,Yes,JSL,FALSE
Colour_game_04_3_Nepal-Indonesia_After_three_weeks.eaf,1,1,19,256682,257976,1294,256705,257966,1261,YELLOW,OS,,NSL,FALSE
Colour_game_04_3_Nepal-Indonesia_After_three_weeks.eaf,1,1,16,600652,602514,1862,600682,601003,321,GREEN,OS,No,ISL,FALSE
Colour_game_04_3_Nepal-Indonesia_After_three_weeks.eaf,1,1,16,600652,602514,1862,601008,601801,793,BRIGHT,NA,,,FALSE
Colour_game_04_3_Nepal-Indonesia_After_three_weeks.eaf,1,1,16,600652,602514,1862,601801,602214,413,SAME,NA,,,FALSE
Colour_game_04_3_Nepal-Indonesia_After_three_weeks.eaf,1,1,16,600652,602514,1862,602214,602468,254,WALL,SAME,Yes,,FALSE
Colour_game_04_3_Nepal-Indonesia_After_three_weeks.eaf,1,1,18,232793,235013,2220,232803,234762,1959,YELLOW,OS#NSL,No,NSL,FALSE
Colour_game_04_3_Nepal-Indonesia_After_three_weeks.eaf,1,2,14,429117,436075,6958,431071,432980,1909,GREEN,OS#ISL,No,ISL,FALSE
Colour_game_04_3_Nepal-Indonesia_After_three_weeks.eaf,1,2,14,429117,436075,6958,433280,433755,475,CORRECT,NA,,,FALSE
Colour_game_04_3_Nepal-Indonesia_After_three_weeks.eaf,1,2,14,429117,436075,6958,433898,435035,1137,GREEN,OS#ISL,No,ISL,FALSE
Colour_game_04_3_Nepal-Indonesia_After_three_weeks.eaf,2,1,5 밤,375859,380919,5060,380820,381800,980,SAME,NA,,,FALSE
Colour_game_04_3_Nepal-Indonesia_After_three_weeks.eaf,2,2,5 밤,375859,380919,5060,379677,380973,1296,BROWN,OS#ISL+NSL,,,FALSE
Colour_game_04_3_Nepal-Indonesia_After_three_weeks.eaf,2,2,20,437780,438899,1119,437774,438591,817,RED,OS#INSL+JSL,Yes,INSL+JSL,FALSE
Colour_game_04_3_Nepal-Indonesia_After_three_weeks.eaf,2,2,7,246279,249692,3413,248974,249432,458,BLACK,OS#ISL,Yes,ISL,FALSE
Colour_game_04_3_Nepal-Indonesia_After_three_weeks.eaf,2,2,1  빨강,215490,216567,1077,215500,216560,1060,RED,OS#INSL+JSL,Yes,INSL+JSL,FALSE
Colour_game_04_3_Nepal-Indonesia_After_three_weeks.eaf,2,2,24  분홍,413927,417578,3651,413959,414445,486,FLOWER,LW,,,FALSE
Colour_game_04_3_Nepal-Indonesia_After_three_weeks.eaf,2,2,24  분홍,413927,417578,3651,414958,415399,441,TONGUE,IX,Yes,,FALSE
Colour_game_04_3_Nepal-Indonesia_After_three_weeks.eaf,2,2,24  분홍,413927,417578,3651,416595,417567,972,FLOWER,LW,,,FALSE
Colour_game_04_3_Nepal-Indonesia_After_three_weeks.eaf,2,2,15,32264,37429,5165,32284,33622,1338,PLANTS,LW,Yes,,FALSE
Colour_game_04_3_Nepal-Indonesia_After_three_weeks.eaf,2,2,15,32264,37429,5165,34049,35749,1700,GREEN,OS,Yes,NSL,FALSE
Colour_game_04_3_Nepal-Indonesia_After_three_weeks.eaf,2,2,15,32264,37429,5165,35749,37395,1646,DARK,NA,,,FALSE